Entity,Code,Year,Urban population,Rural population,Total population
Afghanistan,AFG,1960,724373,7898093,8622466
Afghanistan,AFG,1961,763336,8026804,8790140
Afghanistan,AFG,1962,805062,8163985,8969047
Afghanistan,AFG,1963,849446,8308019,9157465
Afghanistan,AFG,1964,896820,8458694,9355514
Afghanistan,AFG,1965,947332,8617815,9565147
Afghanistan,AFG,1966,1001109,8782038,9783147
Afghanistan,AFG,1967,1058060,8951970,10010030
Afghanistan,AFG,1968,1118853,9128927,10247780
Afghanistan,AFG,1969,1183254,9311235,10494489
Afghanistan,AFG,1970,1251968,9501003,10752971
Afghanistan,AFG,1971,1324216,9691641,11015857
Afghanistan,AFG,1972,1400686,9886067,11286753
Afghanistan,AFG,1973,1482681,10092624,11575305
Afghanistan,AFG,1974,1569079,10300800,11869879
Afghanistan,AFG,1975,1658389,10498997,12157386
Afghanistan,AFG,1976,1748732,10676535,12425267
Afghanistan,AFG,1977,1841815,10845486,12687301
Afghanistan,AFG,1978,1937336,11001526,12938862
Afghanistan,AFG,1979,2005355,10981014,12986369
Afghanistan,AFG,1980,1997237,10489394,12486631
Afghanistan,AFG,1981,1847523,9307672,11155195
Afghanistan,AFG,1982,1729839,8358450,10088289
Afghanistan,AFG,1983,1766084,8185365,9951449
Afghanistan,AFG,1984,1881253,8362433,10243686
Afghanistan,AFG,1985,1997007,8515214,10512221
Afghanistan,AFG,1986,2052805,8395637,10448442
Afghanistan,AFG,1987,2096965,8225793,10322758
Afghanistan,AFG,1988,2180319,8203141,10383460
Afghanistan,AFG,1989,2250758,8422410,10673168
Afghanistan,AFG,1990,2264837,8429959,10694796
Afghanistan,AFG,1991,2285067,8460100,10745167
Afghanistan,AFG,1992,2574865,9482568,12057433
Afghanistan,AFG,1993,3002966,11000794,14003760
Afghanistan,AFG,1994,3328199,12127356,15455555
Afghanistan,AFG,1995,3550426,12868486,16418912
Afghanistan,AFG,1996,3714526,13392069,17106595
Afghanistan,AFG,1997,3878852,13909967,17788819
Afghanistan,AFG,1998,4049071,14444061,18493132
Afghanistan,AFG,1999,4235130,15027717,19262847
Afghanistan,AFG,2000,4314700,15228282,19542982
Afghanistan,AFG,2001,4364773,15323859,19688632
Afghanistan,AFG,2002,4674867,16325389,21000256
Afghanistan,AFG,2003,5061866,17583264,22645130
Afghanistan,AFG,2004,5299549,18254002,23553551
Afghanistan,AFG,2005,5542073,18869118,24411191
Afghanistan,AFG,2006,5828215,19614728,25442943
Afghanistan,AFG,2007,5987030,19916272,25903302
Afghanistan,AFG,2008,6162823,20264376,26427199
Afghanistan,AFG,2009,6443215,20942092,27385307
Afghanistan,AFG,2010,6691382,21498290,28189672
Afghanistan,AFG,2011,7004588,22244568,29249156
Afghanistan,AFG,2012,7360701,23105778,30466479
Afghanistan,AFG,2013,7687539,23853670,31541209
Afghanistan,AFG,2014,8043935,24672276,32716211
Afghanistan,AFG,2015,8371880,25381620,33753500
Afghanistan,AFG,2016,8665979,25970228,34636207
Afghanistan,AFG,2017,8999963,26643456,35643419
Afghanistan,AFG,2018,9353296,27333488,36686784
Afghanistan,AFG,2019,9727157,28042342,37769499
Afghanistan,AFG,2020,10142913,28829316,38972229
Afghanistan,AFG,2021,10551772,29547690,40099462
Albania,ALB,1960,493982,1114818,1608800
Albania,ALB,1961,513592,1146208,1659800
Albania,ALB,1962,530766,1180553,1711319
Albania,ALB,1963,547928,1214693,1762621
Albania,ALB,1964,565248,1248887,1814135
Albania,ALB,1965,582374,1282417,1864791
Albania,ALB,1966,599300,1315273,1914573
Albania,ALB,1967,616687,1348911,1965598
Albania,ALB,1968,635924,1386348,2022272
Albania,ALB,1969,656733,1424962,2081695
Albania,ALB,1970,677801,1457678,2135479
Albania,ALB,1971,698647,1489206,2187853
Albania,ALB,1972,720649,1522477,2243126
Albania,ALB,1973,742333,1554419,2296752
Albania,ALB,1974,764166,1585958,2350124
Albania,ALB,1975,786668,1618163,2404831
Albania,ALB,1976,809052,1649474,2458526
Albania,ALB,1977,832109,1681437,2513546
Albania,ALB,1978,854618,1711648,2566266
Albania,ALB,1979,876974,1740858,2617832
Albania,ALB,1980,902120,1769877,2671997
Albania,ALB,1981,927513,1798543,2726056
Albania,ALB,1982,954645,1829633,2784278
Albania,ALB,1983,982645,1861315,2843960
Albania,ALB,1984,1011235,1893194,2904429
Albania,ALB,1985,1040127,1924635,2964762
Albania,ALB,1986,1068501,1954134,3022635
Albania,ALB,1987,1098349,1985256,3083605
Albania,ALB,1988,1127722,2014614,3142336
Albania,ALB,1989,1167160,2060783,3227943
Albania,ALB,1990,1197222,2089320,3286542
Albania,ALB,1991,1198912,2067878,3266790
Albania,ALB,1992,1209490,2037549,3247039
Albania,ALB,1993,1219882,2007405,3227287
Albania,ALB,1994,1230218,1977318,3207536
Albania,ALB,1995,1240399,1947385,3187784
Albania,ALB,1996,1250518,1917515,3168033
Albania,ALB,1997,1260414,1887867,3148281
Albania,ALB,1998,1270214,1858316,3128530
Albania,ALB,1999,1279853,1828925,3108778
Albania,ALB,2000,1289391,1799636,3089027
Albania,ALB,2001,1298584,1761589,3060173
Albania,ALB,2002,1327220,1723790,3051010
Albania,ALB,2003,1354848,1684768,3039616
Albania,ALB,2004,1381828,1645111,3026939
Albania,ALB,2005,1407298,1604189,3011487
Albania,ALB,2006,1430886,1561661,2992547
Albania,ALB,2007,1452398,1517619,2970017
Albania,ALB,2008,1473392,1473922,2947314
Albania,ALB,2009,1495260,1432259,2927519
Albania,ALB,2010,1519519,1393502,2913021
Albania,ALB,2011,1546929,1358266,2905195
Albania,ALB,2012,1575788,1324613,2900401
Albania,ALB,2013,1603505,1291587,2895092
Albania,ALB,2014,1630119,1258985,2889104
Albania,ALB,2015,1654503,1226200,2880703
Albania,ALB,2016,1680247,1195854,2876101
Albania,ALB,2017,1706345,1167112,2873457
Albania,ALB,2018,1728969,1137407,2866376
Albania,ALB,2019,1747593,1106598,2854191
Albania,ALB,2020,1762645,1075204,2837849
Albania,ALB,2021,1770478,1041188,2811666
Algeria,DZA,1960,3476403,7917904,11394307
Algeria,DZA,1961,3688009,7910599,11598608
Algeria,DZA,1962,3912031,7866229,11778260
Algeria,DZA,1963,4148851,7820600,11969451
Algeria,DZA,1964,4401648,7777451,12179099
Algeria,DZA,1965,4660676,7720580,12381256
Algeria,DZA,1966,4899040,7714349,12613389
Algeria,DZA,1967,5030391,7866724,12897115
Algeria,DZA,1968,5166773,8024202,13190975
Algeria,DZA,1969,5306556,8184460,13491016
Algeria,DZA,1970,5449386,8346529,13795915
Algeria,DZA,1971,5596839,8513432,14110271
Algeria,DZA,1972,5751496,8688252,14439748
Algeria,DZA,1973,5914144,8872325,14786469
Algeria,DZA,1974,6086141,9067461,15153602
Algeria,DZA,1975,6341768,9382924,15724692
Algeria,DZA,1976,6682214,9818302,16500516
Algeria,DZA,1977,7012682,10121510,17134192
Algeria,DZA,1978,7369388,10263257,17632645
Algeria,DZA,1979,7750942,10416039,18166981
Algeria,DZA,1980,8159500,10579878,18739378
Algeria,DZA,1981,8595873,10755484,19351357
Algeria,DZA,1982,9060643,10939453,20000096
Algeria,DZA,1983,9552860,11129251,20682111
Algeria,DZA,1984,10071860,11321670,21393530
Algeria,DZA,1985,10616712,11516193,22132905
Algeria,DZA,1986,11180415,11702138,22882553
Algeria,DZA,1987,11727481,11858620,23586101
Algeria,DZA,1988,12245391,11997627,24243018
Algeria,DZA,1989,12767819,12121688,24889507
Algeria,DZA,1990,13291089,12226985,25518074
Algeria,DZA,1991,13817257,12316648,26133905
Algeria,DZA,1992,14352337,12395966,26748303
Algeria,DZA,1993,14891422,12462905,27354327
Algeria,DZA,1994,15426535,12510471,27937006
Algeria,DZA,1995,15946838,12531184,28478022
Algeria,DZA,1996,16455736,12528898,28984634
Algeria,DZA,1997,16961687,12514344,29476031
Algeria,DZA,1998,17449972,12474696,29924668
Algeria,DZA,1999,17939997,12406086,30346083
Algeria,DZA,2000,18439845,12334776,30774621
Algeria,DZA,2001,18942742,12258243,31200985
Algeria,DZA,2002,19449504,12175192,31624696
Algeria,DZA,2003,19965686,12090197,32055883
Algeria,DZA,2004,20501248,12008938,32510186
Algeria,DZA,2005,21036255,11920435,32956690
Algeria,DZA,2006,21596721,11838359,33435080
Algeria,DZA,2007,22207751,11776076,33983827
Algeria,DZA,2008,22849463,11720129,34569592
Algeria,DZA,2009,23520104,11675933,35196037
Algeria,DZA,2010,24217375,11638969,35856344
Algeria,DZA,2011,24935851,11607690,36543541
Algeria,DZA,2012,25678117,11582446,37260563
Algeria,DZA,2013,26439316,11561310,38000626
Algeria,DZA,2014,27217778,11542390,38760168
Algeria,DZA,2015,28015534,11527620,39543154
Algeria,DZA,2016,28826081,11513248,40339329
Algeria,DZA,2017,29639704,11496842,41136546
Algeria,DZA,2018,30451166,11475841,41927007
Algeria,DZA,2019,31255632,11449736,42705368
Algeria,DZA,2020,32038217,11413449,43451666
Algeria,DZA,2021,32807002,11370967,44177969
American Samoa,ASM,1960,13298,6787,20085
American Samoa,ASM,1961,13745,6881,20626
American Samoa,ASM,1962,14267,7005,21272
American Samoa,ASM,1963,14814,7135,21949
American Samoa,ASM,1964,15387,7269,22656
American Samoa,ASM,1965,15984,7407,23391
American Samoa,ASM,1966,16584,7538,24122
American Samoa,ASM,1967,17186,7662,24848
American Samoa,ASM,1968,17817,7791,25608
American Samoa,ASM,1969,18472,7924,26396
American Samoa,ASM,1970,19056,8019,27075
American Samoa,ASM,1971,19531,8062,27593
American Samoa,ASM,1972,19976,8087,28063
American Samoa,ASM,1973,20420,8109,28529
American Samoa,ASM,1974,20879,8133,29012
American Samoa,ASM,1975,21397,8176,29573
American Samoa,ASM,1976,21966,8232,30198
American Samoa,ASM,1977,22533,8283,30816
American Samoa,ASM,1978,23099,8329,31428
American Samoa,ASM,1979,23672,8373,32045
American Samoa,ASM,1980,24444,8442,32886
American Samoa,ASM,1981,25559,8500,34059
American Samoa,ASM,1982,26788,8579,35367
American Samoa,ASM,1983,28076,8659,36735
American Samoa,ASM,1984,29429,8739,38168
American Samoa,ASM,1985,30843,8820,39663
American Samoa,ASM,1986,32321,8900,41221
American Samoa,ASM,1987,33862,8980,42842
American Samoa,ASM,1988,35474,9058,44532
American Samoa,ASM,1989,37152,9136,46288
American Samoa,ASM,1990,38708,9110,47818
American Samoa,ASM,1991,40118,8874,48992
American Samoa,ASM,1992,41459,8619,50078
American Samoa,ASM,1993,42809,8365,51174
American Samoa,ASM,1994,44176,8112,52288
American Samoa,ASM,1995,45540,7861,53401
American Samoa,ASM,1996,46893,7607,54500
American Samoa,ASM,1997,48226,7352,55578
American Samoa,ASM,1998,49509,7094,56603
American Samoa,ASM,1999,50758,6836,57594
American Samoa,ASM,2000,51584,6646,58230
American Samoa,ASM,2001,51611,6713,58324
American Samoa,ASM,2002,51425,6752,58177
American Samoa,ASM,2003,51160,6781,57941
American Samoa,ASM,2004,50825,6801,57626
American Samoa,ASM,2005,50441,6813,57254
American Samoa,ASM,2006,50017,6820,56837
American Samoa,ASM,2007,49561,6822,56383
American Samoa,ASM,2008,49072,6819,55891
American Samoa,ASM,2009,48554,6812,55366
American Samoa,ASM,2010,48044,6805,54849
American Samoa,ASM,2011,47522,6788,54310
American Samoa,ASM,2012,46937,6754,53691
American Samoa,ASM,2013,46290,6705,52995
American Samoa,ASM,2014,45579,6638,52217
American Samoa,ASM,2015,44812,6556,51368
American Samoa,ASM,2016,43990,6458,50448
American Samoa,ASM,2017,43117,6346,49463
American Samoa,ASM,2018,42203,6221,48424
American Samoa,ASM,2019,41239,6082,47321
American Samoa,ASM,2020,40255,5934,46189
American Samoa,ASM,2021,39257,5778,45035
Andorra,AND,1960,5519,3924,9443
Andorra,AND,1961,6230,3986,10216
Andorra,AND,1962,6990,4024,11014
Andorra,AND,1963,7799,4040,11839
Andorra,AND,1964,8655,4035,12690
Andorra,AND,1965,9554,4009,13563
Andorra,AND,1966,10559,3987,14546
Andorra,AND,1967,11752,3993,15745
Andorra,AND,1968,13080,3999,17079
Andorra,AND,1969,14468,3981,18449
Andorra,AND,1970,15919,3941,19860
Andorra,AND,1971,17437,3885,21322
Andorra,AND,1972,19019,3813,22832
Andorra,AND,1973,20665,3728,24393
Andorra,AND,1974,22371,3632,26003
Andorra,AND,1975,24116,3524,27640
Andorra,AND,1976,25891,3403,29294
Andorra,AND,1977,27675,3274,30949
Andorra,AND,1978,29440,3134,32574
Andorra,AND,1979,31157,2985,34142
Andorra,AND,1980,32785,2826,35611
Andorra,AND,1981,34324,2663,36987
Andorra,AND,1982,36079,2519,38598
Andorra,AND,1983,38042,2390,40432
Andorra,AND,1984,39924,2257,42181
Andorra,AND,1985,41688,2121,43809
Andorra,AND,1986,43473,2132,45605
Andorra,AND,1987,45338,2297,47635
Andorra,AND,1988,47185,2469,49654
Andorra,AND,1989,48991,2648,51639
Andorra,AND,1990,50736,2833,53569
Andorra,AND,1991,52402,3032,55434
Andorra,AND,1992,54032,3251,57283
Andorra,AND,1993,55672,3484,59156
Andorra,AND,1994,57308,3729,61037
Andorra,AND,1995,58939,3989,62928
Andorra,AND,1996,59929,4218,64147
Andorra,AND,1997,60271,4411,64682
Andorra,AND,1998,60575,4611,65186
Andorra,AND,1999,60840,4815,65655
Andorra,AND,2000,61070,5027,66097
Andorra,AND,2001,62432,5388,67820
Andorra,AND,2002,64927,5922,70849
Andorra,AND,2003,67408,6499,73907
Andorra,AND,2004,69817,7116,76933
Andorra,AND,2005,72071,7755,79826
Andorra,AND,2006,72044,8177,80221
Andorra,AND,2007,69810,8358,78168
Andorra,AND,2008,67692,8363,76055
Andorra,AND,2009,65663,8189,73852
Andorra,AND,2010,63522,7997,71519
Andorra,AND,2011,62611,7956,70567
Andorra,AND,2012,62940,8073,71013
Andorra,AND,2013,63186,8181,71367
Andorra,AND,2014,63342,8279,71621
Andorra,AND,2015,63384,8362,71746
Andorra,AND,2016,64015,8525,72540
Andorra,AND,2017,65087,8750,73837
Andorra,AND,2018,66058,8955,75013
Andorra,AND,2019,67170,9173,76343
Andorra,AND,2020,68311,9389,77700
Andorra,AND,2021,69438,9596,79034
Angola,AGO,1960,559023,4798172,5357195
Angola,AGO,1961,587555,4853778,5441333
Angola,AGO,1962,618618,4902782,5521400
Angola,AGO,1963,650924,4948903,5599827
Angola,AGO,1964,684074,4989125,5673199
Angola,AGO,1965,717302,5019280,5736582
Angola,AGO,1966,750290,5036754,5787044
Angola,AGO,1967,783275,5044228,5827503
Angola,AGO,1968,817558,5050645,5868203
Angola,AGO,1969,855822,5072564,5928386
Angola,AGO,1970,901862,5127838,6029700
Angola,AGO,1971,965596,5211453,6177049
Angola,AGO,1972,1047316,5317415,6364731
Angola,AGO,1973,1138692,5439538,6578230
Angola,AGO,1974,1238190,5564304,6802494
Angola,AGO,1975,1345217,5687496,7032713
Angola,AGO,1976,1460041,5806739,7266780
Angola,AGO,1977,1584108,5927787,7511895
Angola,AGO,1978,1719231,6052359,7771590
Angola,AGO,1979,1865383,6177835,8043218
Angola,AGO,1980,2024035,6306012,8330047
Angola,AGO,1981,2195584,6435873,8631457
Angola,AGO,1982,2381016,6566136,8947152
Angola,AGO,1983,2580873,6695834,9276707
Angola,AGO,1984,2795385,6822317,9617702
Angola,AGO,1985,3024887,6945734,9970621
Angola,AGO,1986,3269536,7063038,10332574
Angola,AGO,1987,3526686,7167371,10694057
Angola,AGO,1988,3798425,7261836,11060261
Angola,AGO,1989,4087447,7352051,11439498
Angola,AGO,1990,4393629,7435009,11828638
Angola,AGO,1991,4717829,7510862,12228691
Angola,AGO,1992,5057929,7574578,12632507
Angola,AGO,1993,5412316,7625954,13038270
Angola,AGO,1994,5788673,7673358,13462031
Angola,AGO,1995,6144903,7767350,13912253
Angola,AGO,1996,6522274,7861076,14383350
Angola,AGO,1997,6918801,7952345,14871146
Angola,AGO,1998,7331531,8035333,15366864
Angola,AGO,1999,7760322,8110431,15870753
Angola,AGO,2000,8211294,8182768,16394062
Angola,AGO,2001,8686629,8254958,16941587
Angola,AGO,2002,9189142,8326997,17516139
Angola,AGO,2003,9722803,8401539,18124342
Angola,AGO,2004,10291645,8479480,18771125
Angola,AGO,2005,10892537,8558422,19450959
Angola,AGO,2006,11444951,8717389,20162340
Angola,AGO,2007,12028087,8881597,20909684
Angola,AGO,2008,12642253,9049269,21691522
Angola,AGO,2009,13287180,9220494,22507674
Angola,AGO,2010,13967811,9396374,23364185
Angola,AGO,2011,14683555,9575556,24259111
Angola,AGO,2012,15432363,9755929,25188292
Angola,AGO,2013,16211664,9935338,26147002
Angola,AGO,2014,17017877,10110460,27128337
Angola,AGO,2015,17845914,10281807,28127721
Angola,AGO,2016,18702478,10452268,29154746
Angola,AGO,2017,19586972,10621656,30208628
Angola,AGO,2018,20488542,10784991,31273533
Angola,AGO,2019,21410634,10942954,32353588
Angola,AGO,2020,22338586,11089900,33428486
Angola,AGO,2021,23276246,11227528,34503774
Antigua and Barbuda,ATG,1960,21946,33396,55342
Antigua and Barbuda,ATG,1961,21958,34287,56245
Antigua and Barbuda,ATG,1962,21906,35102,57008
Antigua and Barbuda,ATG,1963,21850,35928,57778
Antigua and Barbuda,ATG,1964,21829,36835,58664
Antigua and Barbuda,ATG,1965,21836,37808,59644
Antigua and Barbuda,ATG,1966,21829,38786,60615
Antigua and Barbuda,ATG,1967,21824,39793,61617
Antigua and Barbuda,ATG,1968,21823,40835,62658
Antigua and Barbuda,ATG,1969,21828,41914,63742
Antigua and Barbuda,ATG,1970,21819,42698,64517
Antigua and Barbuda,ATG,1971,21955,42814,64769
Antigua and Barbuda,ATG,1972,21982,42713,64695
Antigua and Barbuda,ATG,1973,21954,42509,64463
Antigua and Barbuda,ATG,1974,21922,42296,64218
Antigua and Barbuda,ATG,1975,21911,42124,64035
Antigua and Barbuda,ATG,1976,21947,42043,63990
Antigua and Barbuda,ATG,1977,22042,42075,64117
Antigua and Barbuda,ATG,1978,22166,42163,64329
Antigua and Barbuda,ATG,1979,22315,42294,64609
Antigua and Barbuda,ATG,1980,22463,42426,64889
Antigua and Barbuda,ATG,1981,22580,42496,65076
Antigua and Barbuda,ATG,1982,22687,42544,65231
Antigua and Barbuda,ATG,1983,22801,42607,65408
Antigua and Barbuda,ATG,1984,22837,42525,65362
Antigua and Barbuda,ATG,1985,22780,42268,65048
Antigua and Barbuda,ATG,1986,22715,41997,64712
Antigua and Barbuda,ATG,1987,22641,41712,64353
Antigua and Barbuda,ATG,1988,22563,41419,63982
Antigua and Barbuda,ATG,1989,22492,41144,63636
Antigua and Barbuda,ATG,1990,22435,40893,63328
Antigua and Barbuda,ATG,1991,22568,41066,63634
Antigua and Barbuda,ATG,1992,22686,41973,64659
Antigua and Barbuda,ATG,1993,22850,42984,65834
Antigua and Barbuda,ATG,1994,23029,44043,67072
Antigua and Barbuda,ATG,1995,23229,45169,68398
Antigua and Barbuda,ATG,1996,23445,46353,69798
Antigua and Barbuda,ATG,1997,23659,47559,71218
Antigua and Barbuda,ATG,1998,23844,48728,72572
Antigua and Barbuda,ATG,1999,23984,49837,73821
Antigua and Barbuda,ATG,2000,24113,50942,75055
Antigua and Barbuda,ATG,2001,24191,52024,76215
Antigua and Barbuda,ATG,2002,24006,53189,77195
Antigua and Barbuda,ATG,2003,23785,54290,78075
Antigua and Barbuda,ATG,2004,23554,55387,78941
Antigua and Barbuda,ATG,2005,23336,56533,79869
Antigua and Barbuda,ATG,2006,23141,57754,80895
Antigua and Barbuda,ATG,2007,22966,59050,82016
Antigua and Barbuda,ATG,2008,22815,60436,83251
Antigua and Barbuda,ATG,2009,22670,61864,84534
Antigua and Barbuda,ATG,2010,22485,63210,85695
Antigua and Barbuda,ATG,2011,22292,64437,86729
Antigua and Barbuda,ATG,2012,22380,65294,87674
Antigua and Barbuda,ATG,2013,22434,66063,88497
Antigua and Barbuda,ATG,2014,22465,66771,89236
Antigua and Barbuda,ATG,2015,22485,67456,89941
Antigua and Barbuda,ATG,2016,22502,68062,90564
Antigua and Barbuda,ATG,2017,22518,68601,91119
Antigua and Barbuda,ATG,2018,22539,69087,91626
Antigua and Barbuda,ATG,2019,22574,69543,92117
Antigua and Barbuda,ATG,2020,22641,70023,92664
Antigua and Barbuda,ATG,2021,22727,70492,93219
Argentina,ARG,1960,14979650,5370094,20349744
Argentina,ARG,1961,15348560,5332093,20680653
Argentina,ARG,1962,15716292,5304067,21020359
Argentina,ARG,1963,16089028,5274989,21364017
Argentina,ARG,1964,16464585,5243902,21708487
Argentina,ARG,1965,16842160,5211501,22053661
Argentina,ARG,1966,17225308,5177808,22403116
Argentina,ARG,1967,17613474,5143540,22757014
Argentina,ARG,1968,18005236,5107735,23112971
Argentina,ARG,1969,18400662,5071366,23472028
Argentina,ARG,1970,18807203,5035600,23842803
Argentina,ARG,1971,19214226,5009153,24223379
Argentina,ARG,1972,19626980,4985814,24612794
Argentina,ARG,1973,20056003,4964585,25020588
Argentina,ARG,1974,20504103,4945651,25449754
Argentina,ARG,1975,20951181,4924377,25875558
Argentina,ARG,1976,21391331,4898926,26290257
Argentina,ARG,1977,21839851,4873929,26713780
Argentina,ARG,1978,22297552,4848569,27146121
Argentina,ARG,1979,22761324,4822810,27584134
Argentina,ARG,1980,23228918,4795885,28024803
Argentina,ARG,1981,23720282,4751003,28471285
Argentina,ARG,1982,24225416,4697346,28922762
Argentina,ARG,1983,24733787,4643350,29377137
Argentina,ARG,1984,25244303,4587894,29832197
Argentina,ARG,1985,25755554,4531558,30287112
Argentina,ARG,1986,26272907,4475419,30748326
Argentina,ARG,1987,26797140,4419313,31216453
Argentina,ARG,1988,27327921,4362871,31690792
Argentina,ARG,1989,27859735,4306031,32165766
Argentina,ARG,1990,28389540,4248117,32637657
Argentina,ARG,1991,28910601,4195162,33105763
Argentina,ARG,1992,29386348,4181937,33568285
Argentina,ARG,1993,29859584,4167656,34027240
Argentina,ARG,1994,30336257,4152439,34488696
Argentina,ARG,1995,30809888,4136222,34946110
Argentina,ARG,1996,31272164,4117198,35389362
Argentina,ARG,1997,31720057,4095914,35815971
Argentina,ARG,1998,32160222,4072973,36233195
Argentina,ARG,1999,32603604,4049427,36653031
Argentina,ARG,2000,33045629,4025145,37070774
Argentina,ARG,2001,33480950,3999543,37480493
Argentina,ARG,2002,33910889,3974139,37885028
Argentina,ARG,2003,34330154,3948010,38278164
Argentina,ARG,2004,34747780,3921016,38668796
Argentina,ARG,2005,35175563,3894938,39070501
Argentina,ARG,2006,35608120,3868731,39476851
Argentina,ARG,2007,36034446,3841665,39876111
Argentina,ARG,2008,36459843,3813926,40273769
Argentina,ARG,2009,36897033,3787305,40684338
Argentina,ARG,2010,37055902,3732551,40788453
Argentina,ARG,2011,37543830,3717660,41261490
Argentina,ARG,2012,38027774,3705497,41733271
Argentina,ARG,2013,38509756,3693179,42202935
Argentina,ARG,2014,38990109,3679391,42669500
Argentina,ARG,2015,39467043,3664923,43131966
Argentina,ARG,2016,39940546,3649822,43590368
Argentina,ARG,2017,40410674,3634137,44044811
Argentina,ARG,2018,40877099,3617403,44494502
Argentina,ARG,2019,41339571,3599141,44938712
Argentina,ARG,2020,41796990,3579773,45376763
Argentina,ARG,2021,42248949,3559798,45808747
Armenia,ARM,1960,976352,927796,1904148
Armenia,ARM,1961,1028094,943436,1971530
Armenia,ARM,1962,1081241,958105,2039346
Armenia,ARM,1963,1134979,971163,2106142
Armenia,ARM,1964,1188812,982217,2171029
Armenia,ARM,1965,1242624,991427,2234051
Armenia,ARM,1966,1296565,998931,2295496
Armenia,ARM,1967,1350952,1005045,2355997
Armenia,ARM,1968,1406259,1010202,2416461
Armenia,ARM,1969,1462092,1014267,2476359
Armenia,ARM,1970,1517179,1017198,2534377
Armenia,ARM,1971,1571576,1019347,2590923
Armenia,ARM,1972,1627093,1020955,2648048
Armenia,ARM,1973,1684339,1022513,2706852
Armenia,ARM,1974,1743617,1024029,2767646
Armenia,ARM,1975,1800699,1030099,2830798
Armenia,ARM,1976,1859982,1036329,2896311
Armenia,ARM,1977,1922282,1043241,2965523
Armenia,ARM,1978,1987576,1050648,3038224
Armenia,ARM,1979,2039072,1057986,3097058
Armenia,ARM,1980,2070749,1064374,3135123
Armenia,ARM,1981,2099003,1068873,3167876
Armenia,ARM,1982,2128281,1073730,3202011
Armenia,ARM,1983,2159131,1079160,3238291
Armenia,ARM,1984,2188480,1083622,3272102
Armenia,ARM,1985,2214571,1086325,3300896
Armenia,ARM,1986,2239060,1088122,3327182
Armenia,ARM,1987,2262204,1089160,3351364
Armenia,ARM,1988,2279551,1087287,3366838
Armenia,ARM,1989,2334077,1114109,3448186
Armenia,ARM,1990,2397854,1158685,3556539
Armenia,ARM,1991,2429239,1188392,3617631
Armenia,ARM,1992,2390591,1183964,3574555
Armenia,ARM,1993,2302802,1154547,3457349
Armenia,ARM,1994,2237851,1135862,3373713
Armenia,ARM,1995,2194930,1127852,3322782
Armenia,ARM,1996,2170048,1128850,3298898
Armenia,ARM,1997,2142910,1128508,3271418
Armenia,ARM,1998,2113681,1126869,3240550
Armenia,ARM,1999,2082220,1123810,3206030
Armenia,ARM,2000,2048957,1119566,3168523
Armenia,ARM,2001,2017268,1115865,3133133
Armenia,ARM,2002,1994552,1110485,3105037
Armenia,ARM,2003,1978050,1106052,3084102
Armenia,ARM,2004,1963242,1102503,3065745
Armenia,ARM,2005,1948348,1098898,3047246
Armenia,ARM,2006,1932078,1094408,3026486
Armenia,ARM,2007,1914970,1089423,3004393
Armenia,ARM,2008,1898649,1084772,2983421
Armenia,ARM,2009,1883514,1080782,2964296
Armenia,ARM,2010,1869128,1077165,2946293
Armenia,ARM,2011,1855213,1073763,2928976
Armenia,ARM,2012,1843080,1071341,2914421
Armenia,ARM,2013,1832631,1068754,2901385
Armenia,ARM,2014,1823893,1066037,2889930
Armenia,ARM,2015,1815962,1062633,2878595
Armenia,ARM,2016,1807826,1058009,2865835
Armenia,ARM,2017,1799649,1052274,2851923
Armenia,ARM,2018,1791257,1045300,2836557
Armenia,ARM,2019,1783156,1037446,2820602
Armenia,ARM,2020,1776315,1029293,2805608
Armenia,ARM,2021,1770343,1020631,2790974
Aruba,ABW,1960,27728,26880,54608
Aruba,ABW,1961,28330,27481,55811
Aruba,ABW,1962,28764,27918,56682
Aruba,ABW,1963,29157,28318,57475
Aruba,ABW,1964,29505,28673,58178
Aruba,ABW,1965,29802,28980,58782
Aruba,ABW,1966,30052,29239,59291
Aruba,ABW,1967,30160,29362,59522
Aruba,ABW,1968,30124,29347,59471
Aruba,ABW,1969,30044,29286,59330
Aruba,ABW,1970,29922,29184,59106
Aruba,ABW,1971,29766,29050,58816
Aruba,ABW,1972,29777,29078,58855
Aruba,ABW,1973,30026,29339,59365
Aruba,ABW,1974,30352,29676,60028
Aruba,ABW,1975,30690,30025,60715
Aruba,ABW,1976,30922,30271,61193
Aruba,ABW,1977,31050,30415,61465
Aruba,ABW,1978,31179,30559,61738
Aruba,ABW,1979,31305,30701,62006
Aruba,ABW,1980,31427,30840,62267
Aruba,ABW,1981,31593,31021,62614
Aruba,ABW,1982,31836,31280,63116
Aruba,ABW,1983,32113,31570,63683
Aruba,ABW,1984,32351,31823,64174
Aruba,ABW,1985,32494,31984,64478
Aruba,ABW,1986,32522,32031,64553
Aruba,ABW,1987,32460,31990,64450
Aruba,ABW,1988,32391,31941,64332
Aruba,ABW,1989,32514,32082,64596
Aruba,ABW,1990,33066,32646,65712
Aruba,ABW,1991,34138,33726,67864
Aruba,ABW,1992,35095,35097,70192
Aruba,ABW,1993,35882,36478,72360
Aruba,ABW,1994,36740,37970,74710
Aruba,ABW,1995,37575,39475,77050
Aruba,ABW,1996,38403,41014,79417
Aruba,ABW,1997,39248,42610,81858
Aruba,ABW,1998,40099,44256,84355
Aruba,ABW,1999,40938,45929,86867
Aruba,ABW,2000,41625,47476,89101
Aruba,ABW,2001,42025,48666,90691
Aruba,ABW,2002,42194,49587,91781
Aruba,ABW,2003,42277,50424,92701
Aruba,ABW,2004,42317,51223,93540
Aruba,ABW,2005,42399,52084,94483
Aruba,ABW,2006,42555,53051,95606
Aruba,ABW,2007,42729,54058,96787
Aruba,ABW,2008,42906,55090,97996
Aruba,ABW,2009,43079,56133,99212
Aruba,ABW,2010,43206,57135,100341
Aruba,ABW,2011,43493,57795,101288
Aruba,ABW,2012,43864,58248,102112
Aruba,ABW,2013,44228,58652,102880
Aruba,ABW,2014,44588,59006,103594
Aruba,ABW,2015,44943,59314,104257
Aruba,ABW,2016,45297,59577,104874
Aruba,ABW,2017,45648,59791,105439
Aruba,ABW,2018,45999,59963,105962
Aruba,ABW,2019,46351,60091,106442
Aruba,ABW,2020,46574,60011,106585
Aruba,ABW,2021,46734,59803,106537
Australia,AUS,1960,8378309,1898168,10276477
Australia,AUS,1961,8589875,1893125,10483000
Australia,AUS,1962,8832932,1909068,10742000
Australia,AUS,1963,9034955,1915045,10950000
Australia,AUS,1964,9245383,1921617,11167000
Australia,AUS,1965,9459784,1928216,11388000
Australia,AUS,1966,9709943,1941057,11651000
Australia,AUS,1967,9852991,1946009,11799000
Australia,AUS,1968,10048170,1960830,12009000
Australia,AUS,1969,10280809,1982191,12263000
Australia,AUS,1970,10505755,2001245,12507000
Australia,AUS,1971,10887779,2049221,12937000
Australia,AUS,1972,11110846,2066154,13177000
Australia,AUS,1973,11303156,2076844,13380000
Australia,AUS,1974,11614598,2108402,13723000
Australia,AUS,1975,11780153,2112847,13893000
Australia,AUS,1976,11920613,2112387,14033000
Australia,AUS,1977,12077392,2114608,14192000
Australia,AUS,1978,12240482,2117518,14358000
Australia,AUS,1979,12395391,2118609,14514000
Australia,AUS,1980,12569300,2122700,14692000
Australia,AUS,1981,12789234,2134026,14923260
Australia,AUS,1982,13008344,2175903,15184247
Australia,AUS,1983,13183123,2210349,15393472
Australia,AUS,1984,13337672,2241719,15579391
Australia,AUS,1985,13511953,2276359,15788312
Australia,AUS,1986,13704019,2314331,16018350
Australia,AUS,1987,13909190,2354684,16263874
Australia,AUS,1988,14133843,2398321,16532164
Australia,AUS,1989,14370104,2444312,16814416
Australia,AUS,1990,14579251,2485877,17065128
Australia,AUS,1991,14761085,2522951,17284036
Australia,AUS,1992,14906654,2571981,17478635
Australia,AUS,1993,15017273,2617535,17634808
Australia,AUS,1994,15139633,2665835,17805468
Australia,AUS,1995,15285785,2719097,18004882
Australia,AUS,1996,15448588,2776179,18224767
Australia,AUS,1997,15592522,2830515,18423037
Australia,AUS,1998,15723967,2883617,18607584
Australia,AUS,1999,15871907,2940357,18812264
Australia,AUS,2000,16028911,2999891,19028802
Australia,AUS,2001,16210024,3064677,19274701
Australia,AUS,2002,16419256,3075954,19495210
Australia,AUS,2003,16633061,3087676,19720737
Australia,AUS,2004,16835775,3096947,19932722
Australia,AUS,2005,17065978,3110866,20176844
Australia,AUS,2006,17321968,3128998,20450966
Australia,AUS,2007,17666406,3161216,20827622
Australia,AUS,2008,18049707,3199492,21249199
Australia,AUS,2009,18451571,3240082,21691653
Australia,AUS,2010,18767085,3264665,22031750
Australia,AUS,2011,19056040,3283984,22340024
Australia,AUS,2012,19414834,3318631,22733465
Australia,AUS,2013,19775013,3353116,23128129
Australia,AUS,2014,20095657,3380029,23475686
Australia,AUS,2015,20410546,3405449,23815995
Australia,AUS,2016,20755798,3435109,24190907
Australia,AUS,2017,21127403,3466799,24594202
Australia,AUS,2018,21474309,3492334,24966643
Australia,AUS,2019,21824008,3516209,25340217
Australia,AUS,2020,22125378,3529911,25655289
Australia,AUS,2021,22184739,3503340,25688079
Austria,AUT,1960,4561167,2486372,7047539
Austria,AUT,1961,4592914,2493385,7086299
Austria,AUT,1962,4624644,2505220,7129864
Austria,AUT,1963,4658034,2517777,7175811
Austria,AUT,1964,4692726,2531075,7223801
Austria,AUT,1965,4726878,2544011,7270889
Austria,AUT,1966,4763809,2558257,7322066
Austria,AUT,1967,4803163,2573835,7376998
Austria,AUT,1968,4831802,2583601,7415403
Austria,AUT,1969,4852163,2588892,7441055
Austria,AUT,1970,4872871,2594215,7467086
Austria,AUT,1971,4897890,2602592,7500482
Austria,AUT,1972,4927193,2617008,7544201
Austria,AUT,1973,4955326,2630789,7586115
Austria,AUT,1974,4964528,2634510,7599038
Austria,AUT,1975,4952131,2626772,7578903
Austria,AUT,1976,4944146,2621379,7565525
Austria,AUT,1977,4946802,2621628,7568430
Austria,AUT,1978,4943554,2618751,7562305
Austria,AUT,1979,4935890,2613535,7549425
Austria,AUT,1980,4936650,2612783,7549433
Austria,AUT,1981,4947212,2621498,7568710
Austria,AUT,1982,4930765,2643375,7574140
Austria,AUT,1983,4902840,2659070,7561910
Austria,AUT,1984,4882418,2679016,7561434
Austria,AUT,1985,4864664,2700321,7564985
Austria,AUT,1986,4847469,2722325,7569794
Austria,AUT,1987,4830238,2744348,7574586
Austria,AUT,1988,4816676,2768641,7585317
Austria,AUT,1989,4817928,2801639,7619567
Austria,AUT,1990,4833974,2843876,7677850
Austria,AUT,1991,4861464,2893427,7754891
Austria,AUT,1992,4893935,2946774,7840709
Austria,AUT,1993,4912877,2992756,7905633
Austria,AUT,1994,4910076,3026042,7936118
Austria,AUT,1995,4895821,3052457,7948278
Austria,AUT,1996,4880469,3078548,7959017
Austria,AUT,1997,4864091,3103950,7968041
Austria,AUT,1998,4847335,3129454,7976789
Austria,AUT,1999,4834637,3157687,7992324
Austria,AUT,2000,4824004,3187562,8011566
Austria,AUT,2001,4820068,3222225,8042293
Austria,AUT,2002,4821291,3260666,8081957
Austria,AUT,2003,4822095,3299328,8121423
Austria,AUT,2004,4829142,3342824,8171966
Austria,AUT,2005,4839033,3388796,8227829
Austria,AUT,2006,4839801,3428840,8268641
Austria,AUT,2007,4832038,3463449,8295487
Austria,AUT,2008,4823638,3497858,8321496
Austria,AUT,2009,4812679,3530644,8343323
Austria,AUT,2010,4800510,3562894,8363404
Austria,AUT,2011,4792887,3598756,8391643
Austria,AUT,2012,4817487,3612504,8429991
Austria,AUT,2013,4861991,3617832,8479823
Austria,AUT,2014,4916377,3629979,8546356
Austria,AUT,2015,4988134,3654565,8642699
Austria,AUT,2016,5058968,3677700,8736668
Austria,AUT,2017,5110858,3686708,8797566
Austria,AUT,2018,5153759,3686762,8840521
Austria,AUT,2019,5196085,3683835,8879920
Austria,AUT,2020,5238479,3678385,8916864
Austria,AUT,2021,5283472,3672325,8955797
Azerbaijan,AZE,1960,2050961,1843539,3894500
Azerbaijan,AZE,1961,2118517,1927233,4045750
Azerbaijan,AZE,1962,2170106,1998044,4168150
Azerbaijan,AZE,1963,2222513,2071037,4293550
Azerbaijan,AZE,1964,2284616,2154634,4439250
Azerbaijan,AZE,1965,2340574,2234076,4574650
Azerbaijan,AZE,1966,2394753,2313397,4708150
Azerbaijan,AZE,1967,2443252,2388748,4832000
Azerbaijan,AZE,1968,2487265,2461235,4948500
Azerbaijan,AZE,1969,2529777,2533523,5063300
Azerbaijan,AZE,1970,2586439,2585611,5172050
Azerbaijan,AZE,1971,2665882,2617068,5282950
Azerbaijan,AZE,1972,2745165,2646285,5391450
Azerbaijan,AZE,1973,2822271,2671629,5493900
Azerbaijan,AZE,1974,2892038,2702062,5594100
Azerbaijan,AZE,1975,2952446,2736604,5689050
Azerbaijan,AZE,1976,3011670,2769330,5781000
Azerbaijan,AZE,1977,3072874,2803276,5876150
Azerbaijan,AZE,1978,3137001,2839149,5976150
Azerbaijan,AZE,1979,3196843,2874457,6071300
Azerbaijan,AZE,1980,3251327,2909173,6160500
Azerbaijan,AZE,1981,3310162,2947588,6257750
Azerbaijan,AZE,1982,3370646,2986904,6357550
Azerbaijan,AZE,1983,3432673,3027127,6459800
Azerbaijan,AZE,1984,3500598,3067252,6567850
Azerbaijan,AZE,1985,3568397,3101753,6670150
Azerbaijan,AZE,1986,3635448,3134852,6770300
Azerbaijan,AZE,1987,3705470,3169880,6875350
Azerbaijan,AZE,1988,3772840,3201760,6974600
Azerbaijan,AZE,1989,3825371,3251179,7076550
Azerbaijan,AZE,1990,3856598,3318602,7175200
Azerbaijan,AZE,1991,3885855,3385445,7271300
Azerbaijan,AZE,1992,3922231,3459819,7382050
Azerbaijan,AZE,1993,3959053,3535747,7494800
Azerbaijan,AZE,1994,3989328,3607222,7596550
Azerbaijan,AZE,1995,4011953,3672897,7684850
Azerbaijan,AZE,1996,4028686,3734314,7763000
Azerbaijan,AZE,1997,4043596,3794654,7838250
Azerbaijan,AZE,1998,4057628,3855372,7913000
Azerbaijan,AZE,1999,4085971,3896779,7982750
Azerbaijan,AZE,2000,4135854,3912746,8048600
Azerbaijan,AZE,2001,4184325,3926875,8111200
Azerbaijan,AZE,2002,4232008,3939942,8171950
Azerbaijan,AZE,2003,4280744,3953356,8234100
Azerbaijan,AZE,2004,4335079,3971421,8306500
Azerbaijan,AZE,2005,4396406,3995444,8391850
Azerbaijan,AZE,2006,4461940,4022610,8484550
Azerbaijan,AZE,2007,4530068,4051232,8581300
Azerbaijan,AZE,2008,4643726,4119674,8763400
Azerbaijan,AZE,2009,4759039,4188204,8947243
Azerbaijan,AZE,2010,4835557,4218775,9054332
Azerbaijan,AZE,2011,4920166,4252916,9173082
Azerbaijan,AZE,2012,5008847,4286937,9295784
Azerbaijan,AZE,2013,5098727,4318074,9416801
Azerbaijan,AZE,2014,5189181,4345898,9535079
Azerbaijan,AZE,2015,5279540,4369801,9649341
Azerbaijan,AZE,2016,5368846,4388966,9757812
Azerbaijan,AZE,2017,5453517,4400516,9854033
Azerbaijan,AZE,2018,5534464,4405307,9939771
Azerbaijan,AZE,2019,5616706,4407577,10024283
Azerbaijan,AZE,2020,5692217,4400904,10093121
Azerbaijan,AZE,2021,5755809,4381941,10137750
Bahamas,BHS,1960,68370,46130,114500
Bahamas,BHS,1961,72675,47541,120216
Bahamas,BHS,1962,77290,49015,126305
Bahamas,BHS,1963,82138,50501,132639
Bahamas,BHS,1964,86938,51847,138785
Bahamas,BHS,1965,91752,53097,144849
Bahamas,BHS,1966,96907,54416,151323
Bahamas,BHS,1967,102401,55796,158197
Bahamas,BHS,1968,108235,57221,165456
Bahamas,BHS,1969,114172,58573,172745
Bahamas,BHS,1970,119594,59535,179129
Bahamas,BHS,1971,124363,60072,184435
Bahamas,BHS,1972,128810,60371,189181
Bahamas,BHS,1973,133051,60512,193563
Bahamas,BHS,1974,137213,60554,197767
Bahamas,BHS,1975,141351,60530,201881
Bahamas,BHS,1976,145601,60495,206096
Bahamas,BHS,1977,150039,60495,210534
Bahamas,BHS,1978,154551,60465,215016
Bahamas,BHS,1979,159049,60377,219426
Bahamas,BHS,1980,163567,60185,223752
Bahamas,BHS,1981,168330,59626,227956
Bahamas,BHS,1982,173137,59040,232177
Bahamas,BHS,1983,178114,58472,236586
Bahamas,BHS,1984,183255,57911,241166
Bahamas,BHS,1985,188568,57367,245935
Bahamas,BHS,1986,193989,56815,250804
Bahamas,BHS,1987,199400,56218,255618
Bahamas,BHS,1988,204856,55596,260452
Bahamas,BHS,1989,210493,55000,265493
Bahamas,BHS,1990,216105,54574,270679
Bahamas,BHS,1991,221031,55027,276058
Bahamas,BHS,1992,226405,55568,281973
Bahamas,BHS,1993,232024,56140,288164
Bahamas,BHS,1994,237373,56624,293997
Bahamas,BHS,1995,242522,57032,299554
Bahamas,BHS,1996,247545,57388,304933
Bahamas,BHS,1997,252467,57704,310171
Bahamas,BHS,1998,257399,57999,315398
Bahamas,BHS,1999,262059,58213,320272
Bahamas,BHS,2000,266534,58480,325014
Bahamas,BHS,2001,270455,59171,329626
Bahamas,BHS,2002,274189,59813,334002
Bahamas,BHS,2003,278015,60475,338490
Bahamas,BHS,2004,281937,61152,343089
Bahamas,BHS,2005,285957,61847,347804
Bahamas,BHS,2006,290101,62563,352664
Bahamas,BHS,2007,294366,63300,357666
Bahamas,BHS,2008,298736,64059,362795
Bahamas,BHS,2009,303224,64833,368057
Bahamas,BHS,2010,307677,65595,373272
Bahamas,BHS,2011,311718,66232,377950
Bahamas,BHS,2012,315323,66738,382061
Bahamas,BHS,2013,318531,67119,385650
Bahamas,BHS,2014,321687,67444,389131
Bahamas,BHS,2015,324941,67756,392697
Bahamas,BHS,2016,327995,67981,395976
Bahamas,BHS,2017,330887,68133,399020
Bahamas,BHS,2018,333682,68224,401906
Bahamas,BHS,2019,336316,68241,404557
Bahamas,BHS,2020,338367,68104,406471
Bahamas,BHS,2021,340051,67855,407906
Bahrain,BHR,1960,132281,28410,160691
Bahrain,BHR,1961,137478,29492,166970
Bahrain,BHR,1962,142770,30589,173359
Bahrain,BHR,1963,148180,31711,179891
Bahrain,BHR,1964,153727,32860,186587
Bahrain,BHR,1965,159235,33777,193012
Bahrain,BHR,1966,164710,34309,199019
Bahrain,BHR,1967,170119,34797,204916
Bahrain,BHR,1968,175545,35256,210801
Bahrain,BHR,1969,180998,35698,216696
Bahrain,BHR,1970,186445,36110,222555
Bahrain,BHR,1971,194082,36910,230992
Bahrain,BHR,1972,204884,38259,243143
Bahrain,BHR,1973,216864,39768,256632
Bahrain,BHR,1974,229332,41295,270627
Bahrain,BHR,1975,242277,42839,285116
Bahrain,BHR,1976,255655,44389,300044
Bahrain,BHR,1977,269405,45932,315337
Bahrain,BHR,1978,283456,47456,330912
Bahrain,BHR,1979,297750,48947,346697
Bahrain,BHR,1980,312198,50397,362595
Bahrain,BHR,1981,325786,51644,377430
Bahrain,BHR,1982,338351,52666,391017
Bahrain,BHR,1983,351107,53665,404772
Bahrain,BHR,1984,364509,54708,419217
Bahrain,BHR,1985,378580,55795,434375
Bahrain,BHR,1986,393278,56918,450196
Bahrain,BHR,1987,408510,58055,466565
Bahrain,BHR,1988,424148,59189,483337
Bahrain,BHR,1989,440052,60297,500349
Bahrain,BHR,1990,456052,61366,517418
Bahrain,BHR,1991,472927,62488,535415
Bahrain,BHR,1992,490140,64330,554470
Bahrain,BHR,1993,507171,66584,573755
Bahrain,BHR,1994,524389,68865,593254
Bahrain,BHR,1995,541760,71174,612934
Bahrain,BHR,1996,559261,73495,632756
Bahrain,BHR,1997,576819,75824,652643
Bahrain,BHR,1998,594335,78149,672484
Bahrain,BHR,1999,611679,80454,692133
Bahrain,BHR,2000,628716,82726,711442
Bahrain,BHR,2001,645321,84936,730257
Bahrain,BHR,2002,661316,87008,748324
Bahrain,BHR,2003,687846,90410,778256
Bahrain,BHR,2004,736762,96689,833451
Bahrain,BHR,2005,797497,104424,901921
Bahrain,BHR,2006,858852,112129,970981
Bahrain,BHR,2007,920746,119786,1040532
Bahrain,BHR,2008,982987,127356,1110343
Bahrain,BHR,2009,1044748,134705,1179453
Bahrain,BHR,2010,1075702,137943,1213645
Bahrain,BHR,2011,1075052,137025,1212077
Bahrain,BHR,2012,1087280,137659,1224939
Bahrain,BHR,2013,1120807,140866,1261673
Bahrain,BHR,2014,1165795,145339,1311134
Bahrain,BHR,2015,1212293,149849,1362142
Bahrain,BHR,2016,1255867,153794,1409661
Bahrain,BHR,2017,1299292,157542,1456834
Bahrain,BHR,2018,1328001,159339,1487340
Bahrain,BHR,2019,1335714,158474,1494188
Bahrain,BHR,2020,1322423,155046,1477469
Bahrain,BHR,2021,1311407,151858,1463265
Bangladesh,BGD,1960,2587857,47808572,50396429
Bangladesh,BGD,1961,2738373,49144396,51882769
Bangladesh,BGD,1962,2939322,50522340,53461662
Bangladesh,BGD,1963,3155240,51938876,55094116
Bangladesh,BGD,1964,3386029,53388436,56774465
Bangladesh,BGD,1965,3633445,54866710,58500155
Bangladesh,BGD,1966,3897354,56367904,60265258
Bangladesh,BGD,1967,4181495,57922990,62104485
Bangladesh,BGD,1968,4485455,59510196,63995651
Bangladesh,BGD,1969,4805650,61061256,65866906
Bangladesh,BGD,1970,5128453,62413410,67541863
Bangladesh,BGD,1971,5402404,62973800,68376204
Bangladesh,BGD,1972,5700993,63645710,69346703
Bangladesh,BGD,1973,6085016,65059800,71144816
Bangladesh,BGD,1974,6590105,66357704,72947809
Bangladesh,BGD,1975,7347526,67352820,74700346
Bangladesh,BGD,1976,8173432,68206650,76380082
Bangladesh,BGD,1977,9087425,69050360,78137785
Bangladesh,BGD,1978,10104153,69903400,80007553
Bangladesh,BGD,1979,11222236,70685910,81908146
Bangladesh,BGD,1980,12464409,71465360,83929769
Bangladesh,BGD,1981,13613326,72541510,86154836
Bangladesh,BGD,1982,14356591,74198744,88555335
Bangladesh,BGD,1983,15141773,75903704,91045477
Bangladesh,BGD,1984,15956941,77577300,93534241
Bangladesh,BGD,1985,16789004,79170100,95959104
Bangladesh,BGD,1986,17630934,80640820,98271754
Bangladesh,BGD,1987,18485183,82005070,100490253
Bangladesh,BGD,1988,19366087,83322744,102688831
Bangladesh,BGD,1989,20275947,84617730,104893677
Bangladesh,BGD,1990,21227021,85920630,107147651
Bangladesh,BGD,1991,22129321,87113510,109242831
Bangladesh,BGD,1992,22933180,88338920,111272100
Bangladesh,BGD,1993,23779377,89639380,113418757
Bangladesh,BGD,1994,24658344,90956540,115614884
Bangladesh,BGD,1995,25552909,92240430,117793339
Bangladesh,BGD,1996,26449632,93427230,119876862
Bangladesh,BGD,1997,27383162,94656060,122039222
Bangladesh,BGD,1998,28374290,95976184,124350474
Bangladesh,BGD,1999,29409654,97345170,126754824
Bangladesh,BGD,2000,30476706,98716620,129193326
Bangladesh,BGD,2001,31727320,99943170,131670490
Bangladesh,BGD,2002,33207655,100932170,134139825
Bangladesh,BGD,2003,34711400,101791810,136503210
Bangladesh,BGD,2004,36243549,102546180,138789729
Bangladesh,BGD,2005,37777256,103135336,140912592
Bangladesh,BGD,2006,39247175,103381656,142628831
Bangladesh,BGD,2007,40699664,103436270,144135934
Bangladesh,BGD,2008,42125647,103295670,145421317
Bangladesh,BGD,2009,43585126,103121680,146706806
Bangladesh,BGD,2010,45202909,103188230,148391139
Bangladesh,BGD,2011,46903386,103307620,150211006
Bangladesh,BGD,2012,48658361,103432290,152090651
Bangladesh,BGD,2013,50463354,103566780,154030134
Bangladesh,BGD,2014,52301622,103659680,155961302
Bangladesh,BGD,2015,54148316,103681680,157829996
Bangladesh,BGD,2016,56057220,103727340,159784560
Bangladesh,BGD,2017,58016080,103777890,161793970
Bangladesh,BGD,2018,59960707,103723250,163683957
Bangladesh,BGD,2019,61911343,103604880,165516223
Bangladesh,BGD,2020,63916296,103504660,167420956
Bangladesh,BGD,2021,65957486,103398770,169356256
Barbados,BRB,1960,85525,147025,232550
Barbados,BRB,1961,86115,147583,233698
Barbados,BRB,1962,86704,148125,234829
Barbados,BRB,1963,87262,148613,235875
Barbados,BRB,1964,87790,149044,236834
Barbados,BRB,1965,88282,149412,237694
Barbados,BRB,1966,88753,149741,238494
Barbados,BRB,1967,89205,150033,239238
Barbados,BRB,1968,89629,150276,239905
Barbados,BRB,1969,90062,150532,240594
Barbados,BRB,1970,90645,150752,241397
Barbados,BRB,1971,91630,150720,242350
Barbados,BRB,1972,92684,150774,243458
Barbados,BRB,1973,93774,150869,244643
Barbados,BRB,1974,94879,150972,245851
Barbados,BRB,1975,96007,151083,247090
Barbados,BRB,1976,97153,151206,248359
Barbados,BRB,1977,98320,151343,249663
Barbados,BRB,1978,99515,151494,251009
Barbados,BRB,1979,100706,151628,252334
Barbados,BRB,1980,101689,151886,253575
Barbados,BRB,1981,101436,153248,254684
Barbados,BRB,1982,101117,154525,255642
Barbados,BRB,1983,100755,155750,256505
Barbados,BRB,1984,100357,156922,257279
Barbados,BRB,1985,99904,158007,257911
Barbados,BRB,1986,99379,158991,258370
Barbados,BRB,1987,98790,159864,258654
Barbados,BRB,1988,98130,160632,258762
Barbados,BRB,1989,97433,161326,258759
Barbados,BRB,1990,96739,162129,258868
Barbados,BRB,1991,95994,163408,259402
Barbados,BRB,1992,95349,164863,260212
Barbados,BRB,1993,94697,166298,260995
Barbados,BRB,1994,94017,167695,261712
Barbados,BRB,1995,93291,169012,262303
Barbados,BRB,1996,92529,170264,262793
Barbados,BRB,1997,91749,171475,263224
Barbados,BRB,1998,90964,172678,263642
Barbados,BRB,1999,90219,173951,264170
Barbados,BRB,2000,89526,175131,264657
Barbados,BRB,2001,89244,176133,265377
Barbados,BRB,2002,89079,177376,266455
Barbados,BRB,2003,88901,178598,267499
Barbados,BRB,2004,88706,179799,268505
Barbados,BRB,2005,88499,180978,269477
Barbados,BRB,2006,88283,182142,270425
Barbados,BRB,2007,88086,183358,271444
Barbados,BRB,2008,87941,184694,272635
Barbados,BRB,2009,87786,186005,273791
Barbados,BRB,2010,87550,187161,274711
Barbados,BRB,2011,87329,188157,275486
Barbados,BRB,2012,87148,189049,276197
Barbados,BRB,2013,87016,189849,276865
Barbados,BRB,2014,86933,190560,277493
Barbados,BRB,2015,86898,191185,278083
Barbados,BRB,2016,86919,191730,278649
Barbados,BRB,2017,86992,192195,279187
Barbados,BRB,2018,87114,192574,279688
Barbados,BRB,2019,87298,192882,280180
Barbados,BRB,2020,87551,193142,280693
Barbados,BRB,2021,87864,193336,281200
Belarus,BLR,1960,2656234,5541766,8198000
Belarus,BLR,1961,2772677,5498539,8271216
Belarus,BLR,1962,2895029,5456899,8351928
Belarus,BLR,1963,3022385,5414847,8437232
Belarus,BLR,1964,3153963,5370261,8524224
Belarus,BLR,1965,3282735,5327265,8610000
Belarus,BLR,1966,3415027,5281469,8696496
Belarus,BLR,1967,3551335,5234313,8785648
Belarus,BLR,1968,3690749,5183803,8874552
Belarus,BLR,1969,3831426,5128878,8960304
Belarus,BLR,1970,3978504,5061496,9040000
Belarus,BLR,1971,4133823,4981753,9115576
Belarus,BLR,1972,4290972,4897996,9188968
Belarus,BLR,1973,4447749,4809523,9257272
Belarus,BLR,1974,4602886,4714698,9317584
Belarus,BLR,1975,4741013,4625987,9367000
Belarus,BLR,1976,4877627,4533373,9411000
Belarus,BLR,1977,5019081,4443919,9463000
Belarus,BLR,1978,5167027,4357973,9525000
Belarus,BLR,1979,5309728,4274272,9584000
Belarus,BLR,1980,5448102,4194898,9643000
Belarus,BLR,1981,5591406,4118594,9710000
Belarus,BLR,1982,5734993,4041007,9776000
Belarus,BLR,1983,5879814,3963186,9843000
Belarus,BLR,1984,6025280,3884720,9910000
Belarus,BLR,1985,6167842,3807158,9975000
Belarus,BLR,1986,6312729,3730271,10043000
Belarus,BLR,1987,6457896,3653104,10111000
Belarus,BLR,1988,6578021,3561979,10140000
Belarus,BLR,1989,6669994,3500006,10170000
Belarus,BLR,1990,6723034,3466314,10189348
Belarus,BLR,1991,6766199,3427851,10194050
Belarus,BLR,1992,6821128,3395342,10216470
Belarus,BLR,1993,6876034,3363016,10239050
Belarus,BLR,1994,6907388,3319567,10226955
Belarus,BLR,1995,6924262,3269569,10193831
Belarus,BLR,1996,6939798,3219771,10159569
Belarus,BLR,1997,6949361,3168072,10117433
Belarus,BLR,1998,6956101,3115862,10071963
Belarus,BLR,1999,6966778,3059960,10026738
Belarus,BLR,2000,6983033,2996577,9979610
Belarus,BLR,2001,6995457,2933092,9928549
Belarus,BLR,2002,6998521,2867027,9865548
Belarus,BLR,2003,6996348,2800401,9796749
Belarus,BLR,2004,6994710,2735436,9730146
Belarus,BLR,2005,6992229,2671686,9663915
Belarus,BLR,2006,6993921,2611003,9604924
Belarus,BLR,2007,7005597,2555356,9560953
Belarus,BLR,2008,7024602,2503383,9527985
Belarus,BLR,2009,7049739,2454844,9504583
Belarus,BLR,2010,7081770,2402066,9483836
Belarus,BLR,2011,7114020,2347623,9461643
Belarus,BLR,2012,7150971,2295865,9446836
Belarus,BLR,2013,7195632,2247579,9443211
Belarus,BLR,2014,7246350,2202165,9448515
Belarus,BLR,2015,7302153,2158923,9461076
Belarus,BLR,2016,7354014,2115365,9469379
Belarus,BLR,2017,7390686,2068303,9458989
Belarus,BLR,2018,7418413,2020372,9438785
Belarus,BLR,2019,7445754,1974004,9419758
Belarus,BLR,2020,7455467,1924485,9379952
Belarus,BLR,2021,7463845,1876469,9340314
Belgium,BEL,1960,8463316,690173,9153489
Belgium,BEL,1961,8500111,683837,9183948
Belgium,BEL,1962,8545539,675039,9220578
Belgium,BEL,1963,8624158,665612,9289770
Belgium,BEL,1964,8720520,657593,9378113
Belgium,BEL,1965,8814176,649491,9463667
Belgium,BEL,1966,8887919,639888,9527807
Belgium,BEL,1967,8951328,629663,9580991
Belgium,BEL,1968,9000174,618582,9618756
Belgium,BEL,1969,9039007,607025,9646032
Belgium,BEL,1970,9061057,594492,9655549
Belgium,BEL,1971,9090451,582711,9673162
Belgium,BEL,1972,9138742,572373,9711115
Belgium,BEL,1973,9179915,561805,9741720
Belgium,BEL,1974,9221059,551360,9772419
Belgium,BEL,1975,9259701,540999,9800700
Belgium,BEL,1976,9288043,530184,9818227
Belgium,BEL,1977,9319769,510589,9830358
Belgium,BEL,1978,9348049,491485,9839534
Belgium,BEL,1979,9375266,473116,9848382
Belgium,BEL,1980,9403844,455398,9859242
Belgium,BEL,1981,9418778,440204,9858982
Belgium,BEL,1982,9426273,430030,9856303
Belgium,BEL,1983,9435379,420141,9855520
Belgium,BEL,1984,9444896,410476,9855372
Belgium,BEL,1985,9457075,401233,9858308
Belgium,BEL,1986,9469618,392205,9861823
Belgium,BEL,1987,9486775,383459,9870234
Belgium,BEL,1988,9525797,375867,9901664
Belgium,BEL,1989,9569207,368490,9937697
Belgium,BEL,1990,9606261,361118,9967379
Belgium,BEL,1991,9650427,354059,10004486
Belgium,BEL,1992,9697796,347362,10045158
Belgium,BEL,1993,9743821,340654,10084475
Belgium,BEL,1994,9781788,333815,10115603
Belgium,BEL,1995,9810102,326709,10136811
Belgium,BEL,1996,9836805,319832,10156637
Belgium,BEL,1997,9868070,313175,10181245
Belgium,BEL,1998,9896510,306498,10203008
Belgium,BEL,1999,9926274,300145,10226419
Belgium,BEL,2000,9956937,294313,10251250
Belgium,BEL,2001,9997106,289464,10286570
Belgium,BEL,2002,10047703,285082,10332785
Belgium,BEL,2003,10095562,280571,10376133
Belgium,BEL,2004,10144977,276160,10421137
Belgium,BEL,2005,10206487,272130,10478617
Belgium,BEL,2006,10279407,268551,10547958
Belgium,BEL,2007,10360589,265111,10625700
Belgium,BEL,2008,10448114,261859,10709973
Belgium,BEL,2009,10537701,258792,10796493
Belgium,BEL,2010,10639649,255937,10895586
Belgium,BEL,2011,10784163,254101,11038264
Belgium,BEL,2012,10856360,250572,11106932
Belgium,BEL,2013,10912673,246734,11159407
Belgium,BEL,2014,10966157,242900,11209057
Belgium,BEL,2015,11034732,239464,11274196
Belgium,BEL,2016,11095615,235807,11331422
Belgium,BEL,2017,11143219,231939,11375158
Belgium,BEL,2018,11198627,228427,11427054
Belgium,BEL,2019,11263911,225069,11488980
Belgium,BEL,2020,11316947,221657,11538604
Belgium,BEL,2021,11374657,218295,11592952
Belize,BLZ,1960,49383,42020,91403
Belize,BLZ,1961,50366,43391,93757
Belize,BLZ,1962,51374,44814,96188
Belize,BLZ,1963,52497,46365,98862
Belize,BLZ,1964,53725,48047,101772
Belize,BLZ,1965,55020,49818,104838
Belize,BLZ,1966,56376,51686,108062
Belize,BLZ,1967,57778,53633,111411
Belize,BLZ,1968,59191,55634,114825
Belize,BLZ,1969,60535,57610,118145
Belize,BLZ,1970,61617,59288,120905
Belize,BLZ,1971,62536,60555,123091
Belize,BLZ,1972,63335,61719,125054
Belize,BLZ,1973,64057,62818,126875
Belize,BLZ,1974,64733,63887,128620
Belize,BLZ,1975,65624,65177,130801
Belize,BLZ,1976,66752,66719,133471
Belize,BLZ,1977,67893,68290,136183
Belize,BLZ,1978,69043,69890,138933
Belize,BLZ,1979,70255,71568,141823
Belize,BLZ,1980,71658,73475,145133
Belize,BLZ,1981,73167,75597,148764
Belize,BLZ,1982,74668,77741,152409
Belize,BLZ,1983,76155,79898,156053
Belize,BLZ,1984,77640,82081,159721
Belize,BLZ,1985,79134,84302,163436
Belize,BLZ,1986,80633,86558,167191
Belize,BLZ,1987,82134,88846,170980
Belize,BLZ,1988,83643,91174,174817
Belize,BLZ,1989,85157,93538,178695
Belize,BLZ,1990,86666,95923,182589
Belize,BLZ,1991,88142,98320,186462
Belize,BLZ,1992,89553,100746,190299
Belize,BLZ,1993,90968,103209,194177
Belize,BLZ,1994,92535,105881,198416
Belize,BLZ,1995,94501,109055,203556
Belize,BLZ,1996,96975,112865,209840
Belize,BLZ,1997,99880,117237,217117
Belize,BLZ,1998,102992,121915,224907
Belize,BLZ,1999,106084,126649,232733
Belize,BLZ,2000,109140,131266,240406
Belize,BLZ,2001,112590,135510,248100
Belize,BLZ,2002,116126,139861,255987
Belize,BLZ,2003,119715,144283,263998
Belize,BLZ,2004,123356,148772,272128
Belize,BLZ,2005,127046,153329,280375
Belize,BLZ,2006,130783,157946,288729
Belize,BLZ,2007,134557,162616,297173
Belize,BLZ,2008,138353,167318,305671
Belize,BLZ,2009,142147,172024,314171
Belize,BLZ,2010,145682,176424,322106
Belize,BLZ,2011,149043,180495,329538
Belize,BLZ,2012,152506,184553,337059
Belize,BLZ,2013,156082,188606,344688
Belize,BLZ,2014,159731,192604,352335
Belize,BLZ,2015,163403,196468,359871
Belize,BLZ,2016,167109,200204,367313
Belize,BLZ,2017,170864,203829,374693
Belize,BLZ,2018,174696,207370,382066
Belize,BLZ,2019,178462,210633,389095
Belize,BLZ,2020,181762,213159,394921
Belize,BLZ,2021,184818,215213,400031
Benin,BEN,1960,233014,2279270,2512284
Benin,BEN,1961,251448,2299768,2551216
Benin,BEN,1962,271519,2321783,2593302
Benin,BEN,1963,293302,2344780,2638082
Benin,BEN,1964,316930,2368689,2685619
Benin,BEN,1965,342500,2393343,2735843
Benin,BEN,1966,370192,2418450,2788642
Benin,BEN,1967,400086,2443653,2843739
Benin,BEN,1968,432369,2468849,2901218
Benin,BEN,1969,467154,2494012,2961166
Benin,BEN,1970,504643,2518800,3023443
Benin,BEN,1971,545007,2543374,3088381
Benin,BEN,1972,588607,2567801,3156408
Benin,BEN,1973,635439,2591941,3227380
Benin,BEN,1974,685840,2615436,3301276
Benin,BEN,1975,740071,2638632,3378703
Benin,BEN,1976,798609,2661720,3460329
Benin,BEN,1977,861540,2684914,3546454
Benin,BEN,1978,929308,2707619,3636927
Benin,BEN,1979,995653,2736741,3732394
Benin,BEN,1980,1048161,2785778,3833939
Benin,BEN,1981,1104033,2837536,3941569
Benin,BEN,1982,1163284,2891101,4054385
Benin,BEN,1983,1225761,2945765,4171526
Benin,BEN,1984,1291613,3001457,4293070
Benin,BEN,1985,1361045,3058507,4419552
Benin,BEN,1986,1434459,3116923,4551382
Benin,BEN,1987,1511946,3176841,4688787
Benin,BEN,1988,1593711,3237913,4831624
Benin,BEN,1989,1679646,3300034,4979680
Benin,BEN,1990,1770260,3363159,5133419
Benin,BEN,1991,1865640,3427406,5293046
Benin,BEN,1992,1955358,3502420,5457778
Benin,BEN,1993,2061986,3644195,5706181
Benin,BEN,1994,2158899,3764495,5923394
Benin,BEN,1995,2222577,3823934,6046511
Benin,BEN,1996,2299833,3904027,6203860
Benin,BEN,1997,2387790,3999236,6387026
Benin,BEN,1998,2482171,4102012,6584183
Benin,BEN,1999,2580682,4207907,6788589
Benin,BEN,2000,2682552,4315471,6998023
Benin,BEN,2001,2787454,4424587,7212041
Benin,BEN,2002,2901071,4530712,7431783
Benin,BEN,2003,3028144,4631064,7659208
Benin,BEN,2004,3160900,4733654,7894554
Benin,BEN,2005,3304019,4845400,8149419
Benin,BEN,2006,3449196,4953435,8402631
Benin,BEN,2007,3593837,5053924,8647761
Benin,BEN,2008,3746862,5159607,8906469
Benin,BEN,2009,3905656,5266858,9172514
Benin,BEN,2010,4070440,5375270,9445710
Benin,BEN,2011,4241480,5484900,9726380
Benin,BEN,2012,4418712,5595366,10014078
Benin,BEN,2013,4602023,5706707,10308730
Benin,BEN,2014,4794300,5820544,10614844
Benin,BEN,2015,4995735,5937048,10932783
Benin,BEN,2016,5205425,6054660,11260085
Benin,BEN,2017,5423582,6173197,11596779
Benin,BEN,2018,5649376,6291307,11940683
Benin,BEN,2019,5882329,6408115,12290444
Benin,BEN,2020,6121168,6521955,12643123
Benin,BEN,2021,6364839,6632056,12996895
Bermuda,BMU,1960,44400,0,44400
Bermuda,BMU,1961,45500,0,45500
Bermuda,BMU,1962,46600,0,46600
Bermuda,BMU,1963,47700,0,47700
Bermuda,BMU,1964,48900,0,48900
Bermuda,BMU,1965,50100,0,50100
Bermuda,BMU,1966,51000,0,51000
Bermuda,BMU,1967,52000,0,52000
Bermuda,BMU,1968,53000,0,53000
Bermuda,BMU,1969,54000,0,54000
Bermuda,BMU,1970,55000,0,55000
Bermuda,BMU,1971,54600,0,54600
Bermuda,BMU,1972,54200,0,54200
Bermuda,BMU,1973,53800,0,53800
Bermuda,BMU,1974,53400,0,53400
Bermuda,BMU,1975,53000,0,53000
Bermuda,BMU,1976,53200,0,53200
Bermuda,BMU,1977,53400,0,53400
Bermuda,BMU,1978,53600,0,53600
Bermuda,BMU,1979,53800,0,53800
Bermuda,BMU,1980,54670,0,54670
Bermuda,BMU,1981,55050,0,55050
Bermuda,BMU,1982,55449,0,55449
Bermuda,BMU,1983,55930,0,55930
Bermuda,BMU,1984,56423,0,56423
Bermuda,BMU,1985,56898,0,56898
Bermuda,BMU,1986,57382,0,57382
Bermuda,BMU,1987,57849,0,57849
Bermuda,BMU,1988,58347,0,58347
Bermuda,BMU,1989,58841,0,58841
Bermuda,BMU,1990,59326,0,59326
Bermuda,BMU,1991,59021,0,59021
Bermuda,BMU,1992,58595,0,58595
Bermuda,BMU,1993,58910,0,58910
Bermuda,BMU,1994,59320,0,59320
Bermuda,BMU,1995,59746,0,59746
Bermuda,BMU,1996,60129,0,60129
Bermuda,BMU,1997,60497,0,60497
Bermuda,BMU,1998,60943,0,60943
Bermuda,BMU,1999,61285,0,61285
Bermuda,BMU,2000,61833,0,61833
Bermuda,BMU,2001,62504,0,62504
Bermuda,BMU,2002,62912,0,62912
Bermuda,BMU,2003,63325,0,63325
Bermuda,BMU,2004,63740,0,63740
Bermuda,BMU,2005,64154,0,64154
Bermuda,BMU,2006,64523,0,64523
Bermuda,BMU,2007,64888,0,64888
Bermuda,BMU,2008,65273,0,65273
Bermuda,BMU,2009,65636,0,65636
Bermuda,BMU,2010,65124,0,65124
Bermuda,BMU,2011,64564,0,64564
Bermuda,BMU,2012,64798,0,64798
Bermuda,BMU,2013,65001,0,65001
Bermuda,BMU,2014,65138,0,65138
Bermuda,BMU,2015,65237,0,65237
Bermuda,BMU,2016,64554,0,64554
Bermuda,BMU,2017,63873,0,63873
Bermuda,BMU,2018,63918,0,63918
Bermuda,BMU,2019,63911,0,63911
Bermuda,BMU,2020,63893,0,63893
Bermuda,BMU,2021,63867,0,63867
Bhutan,BTN,1960,7957,213309,221266
Bhutan,BTN,1961,8611,218460,227071
Bhutan,BTN,1962,9334,224083,233417
Bhutan,BTN,1963,10132,230136,240268
Bhutan,BTN,1964,11001,236443,247444
Bhutan,BTN,1965,11952,243058,255010
Bhutan,BTN,1966,12991,249985,262976
Bhutan,BTN,1967,14129,257210,271339
Bhutan,BTN,1968,15369,264733,280102
Bhutan,BTN,1969,16724,272572,289296
Bhutan,BTN,1970,18200,280694,298894
Bhutan,BTN,1971,19806,289031,308837
Bhutan,BTN,1972,21554,297574,319128
Bhutan,BTN,1973,23449,306351,329800
Bhutan,BTN,1974,25509,315333,340842
Bhutan,BTN,1975,27745,324524,352269
Bhutan,BTN,1976,30178,333941,364119
Bhutan,BTN,1977,32810,343577,376387
Bhutan,BTN,1978,35670,353402,389072
Bhutan,BTN,1979,38755,363308,402063
Bhutan,BTN,1980,42074,373183,415257
Bhutan,BTN,1981,45633,383008,428641
Bhutan,BTN,1982,49456,392745,442201
Bhutan,BTN,1983,53561,402472,456033
Bhutan,BTN,1984,57981,412184,470165
Bhutan,BTN,1985,62703,421825,484528
Bhutan,BTN,1986,67770,431381,499151
Bhutan,BTN,1987,73197,440829,514026
Bhutan,BTN,1988,78982,450069,529051
Bhutan,BTN,1989,85141,459068,544209
Bhutan,BTN,1990,91517,466925,558442
Bhutan,BTN,1991,97425,470285,567710
Bhutan,BTN,1992,98062,447882,545944
Bhutan,BTN,1993,97871,422967,520838
Bhutan,BTN,1994,102422,418838,521260
Bhutan,BTN,1995,108340,419196,527536
Bhutan,BTN,1996,115325,422169,537494
Bhutan,BTN,1997,122503,424362,546865
Bhutan,BTN,1998,130243,426900,557143
Bhutan,BTN,1999,139224,431766,570990
Bhutan,BTN,2000,149256,437951,587207
Bhutan,BTN,2001,159736,443498,603234
Bhutan,BTN,2002,170672,448376,619048
Bhutan,BTN,2003,182062,452565,634627
Bhutan,BTN,2004,193925,456066,649991
Bhutan,BTN,2005,205398,457925,663323
Bhutan,BTN,2006,213504,459756,673260
Bhutan,BTN,2007,221313,460301,681614
Bhutan,BTN,2008,229241,460496,689737
Bhutan,BTN,2009,237280,460398,697678
Bhutan,BTN,2010,245470,460046,705516
Bhutan,BTN,2011,253839,459492,713331
Bhutan,BTN,2012,262288,458857,721145
Bhutan,BTN,2013,270775,458114,728889
Bhutan,BTN,2014,279212,457145,736357
Bhutan,BTN,2015,287484,455790,743274
Bhutan,BTN,2016,295616,454145,749761
Bhutan,BTN,2017,303711,452410,756121
Bhutan,BTN,2018,311659,450437,762096
Bhutan,BTN,2019,319355,448104,767459
Bhutan,BTN,2020,326894,445612,772506
Bhutan,BTN,2021,334381,443105,777486
Bolivia,BOL,1960,1362957,2344558,3707515
Bolivia,BOL,1961,1402588,2382156,3784744
Bolivia,BOL,1962,1443527,2420613,3864140
Bolivia,BOL,1963,1485804,2459925,3945729
Bolivia,BOL,1964,1529467,2500005,4029472
Bolivia,BOL,1965,1574471,2541040,4115511
Bolivia,BOL,1966,1621045,2583020,4204065
Bolivia,BOL,1967,1669227,2626042,4295269
Bolivia,BOL,1968,1719093,2670156,4389249
Bolivia,BOL,1969,1770663,2715435,4486098
Bolivia,BOL,1970,1824005,2761688,4585693
Bolivia,BOL,1971,1879151,2809116,4688267
Bolivia,BOL,1972,1936169,2857635,4793804
Bolivia,BOL,1973,1995019,2907229,4902248
Bolivia,BOL,1974,2055844,2957921,5013765
Bolivia,BOL,1975,2118489,3009287,5127776
Bolivia,BOL,1976,2182910,3061445,5244355
Bolivia,BOL,1977,2276768,3087149,5363917
Bolivia,BOL,1978,2383285,3102847,5486132
Bolivia,BOL,1979,2493421,3116959,5610380
Bolivia,BOL,1980,2607109,3128979,5736088
Bolivia,BOL,1981,2723887,3139103,5862990
Bolivia,BOL,1982,2844104,3147014,5991118
Bolivia,BOL,1983,2967644,3152976,6120620
Bolivia,BOL,1984,3094953,3156973,6251926
Bolivia,BOL,1985,3225956,3159674,6385630
Bolivia,BOL,1986,3361104,3160879,6521983
Bolivia,BOL,1987,3500517,3160917,6661434
Bolivia,BOL,1988,3644465,3159607,6804072
Bolivia,BOL,1989,3792215,3156924,6949139
Bolivia,BOL,1990,3943852,3152342,7096194
Bolivia,BOL,1991,4099087,3145804,7244891
Bolivia,BOL,1992,4254823,3139596,7394419
Bolivia,BOL,1993,4381764,3162725,7544489
Bolivia,BOL,1994,4509675,3184047,7693722
Bolivia,BOL,1995,4638230,3203241,7841471
Bolivia,BOL,1996,4768214,3221153,7989367
Bolivia,BOL,1997,4899823,3237796,8137619
Bolivia,BOL,1998,5033397,3253531,8286928
Bolivia,BOL,1999,5170101,3268951,8439052
Bolivia,BOL,2000,5309144,3283512,8592656
Bolivia,BOL,2001,5449335,3296749,8746084
Bolivia,BOL,2002,5588053,3312530,8900583
Bolivia,BOL,2003,5728610,3328768,9057378
Bolivia,BOL,2004,5871784,3344495,9216279
Bolivia,BOL,2005,6017470,3359918,9377388
Bolivia,BOL,2006,6167232,3375431,9542663
Bolivia,BOL,2007,6320212,3390940,9711152
Bolivia,BOL,2008,6475247,3405346,9880593
Bolivia,BOL,2009,6632261,3419056,10051317
Bolivia,BOL,2010,6791318,3431952,10223270
Bolivia,BOL,2011,6952386,3443860,10396246
Bolivia,BOL,2012,7114992,3454705,10569697
Bolivia,BOL,2013,7273140,3470209,10743349
Bolivia,BOL,2014,7428682,3488305,10916987
Bolivia,BOL,2015,7584842,3505243,11090085
Bolivia,BOL,2016,7741971,3521044,11263015
Bolivia,BOL,2017,7899666,3535867,11435533
Bolivia,BOL,2018,8058094,3548811,11606905
Bolivia,BOL,2019,8217386,3559929,11777315
Bolivia,BOL,2020,8369995,3566167,11936162
Bolivia,BOL,2021,8513008,3566464,12079472
Bosnia and Herzegovina,BIH,1960,621187,2641352,3262539
Bosnia and Herzegovina,BIH,1961,654625,2670708,3325333
Bosnia and Herzegovina,BIH,1962,692306,2695206,3387512
Bosnia and Herzegovina,BIH,1963,731399,2717133,3448532
Bosnia and Herzegovina,BIH,1964,771891,2736068,3507959
Bosnia and Herzegovina,BIH,1965,813544,2751973,3565517
Bosnia and Herzegovina,BIH,1966,856403,2764446,3620849
Bosnia and Herzegovina,BIH,1967,900306,2773061,3673367
Bosnia and Herzegovina,BIH,1968,945175,2777892,3723067
Bosnia and Herzegovina,BIH,1969,990968,2779408,3770376
Bosnia and Herzegovina,BIH,1970,1037871,2777690,3815561
Bosnia and Herzegovina,BIH,1971,1084215,2775027,3859242
Bosnia and Herzegovina,BIH,1972,1126672,2775223,3901895
Bosnia and Herzegovina,BIH,1973,1169775,2773377,3943152
Bosnia and Herzegovina,BIH,1974,1213679,2769384,3983063
Bosnia and Herzegovina,BIH,1975,1258432,2763658,4022090
Bosnia and Herzegovina,BIH,1976,1304003,2756036,4060039
Bosnia and Herzegovina,BIH,1977,1350089,2746427,4096516
Bosnia and Herzegovina,BIH,1978,1396785,2734736,4131521
Bosnia and Herzegovina,BIH,1979,1444183,2721328,4165511
Bosnia and Herzegovina,BIH,1980,1492742,2707078,4199820
Bosnia and Herzegovina,BIH,1981,1536895,2699075,4235970
Bosnia and Herzegovina,BIH,1982,1564588,2709425,4274013
Bosnia and Herzegovina,BIH,1983,1592743,2719778,4312521
Bosnia and Herzegovina,BIH,1984,1620703,2728894,4349597
Bosnia and Herzegovina,BIH,1985,1647641,2735665,4383306
Bosnia and Herzegovina,BIH,1986,1673507,2739867,4413374
Bosnia and Herzegovina,BIH,1987,1698415,2741885,4440300
Bosnia and Herzegovina,BIH,1988,1722083,2741237,4463320
Bosnia and Herzegovina,BIH,1989,1743871,2737359,4481230
Bosnia and Herzegovina,BIH,1990,1763972,2730338,4494310
Bosnia and Herzegovina,BIH,1991,1781954,2720432,4502386
Bosnia and Herzegovina,BIH,1992,1705460,2570270,4275730
Bosnia and Herzegovina,BIH,1993,1584921,2358060,3942981
Bosnia and Herzegovina,BIH,1994,1523969,2238361,3762330
Bosnia and Herzegovina,BIH,1995,1530853,2219674,3750527
Bosnia and Herzegovina,BIH,1996,1607258,2300493,3907751
Bosnia and Herzegovina,BIH,1997,1677468,2370280,4047748
Bosnia and Herzegovina,BIH,1998,1718243,2396816,4115059
Bosnia and Herzegovina,BIH,1999,1747131,2405883,4153014
Bosnia and Herzegovina,BIH,2000,1771376,2407974,4179350
Bosnia and Herzegovina,BIH,2001,1791152,2403780,4194932
Bosnia and Herzegovina,BIH,2002,1805904,2392506,4198410
Bosnia and Herzegovina,BIH,2003,1812822,2370935,4183757
Bosnia and Herzegovina,BIH,2004,1808276,2334584,4142860
Bosnia and Herzegovina,BIH,2005,1800058,2294239,4094297
Bosnia and Herzegovina,BIH,2006,1797002,2261084,4058086
Bosnia and Herzegovina,BIH,2007,1787553,2220323,4007876
Bosnia and Herzegovina,BIH,2008,1771372,2172020,3943392
Bosnia and Herzegovina,BIH,2009,1754255,2123495,3877750
Bosnia and Herzegovina,BIH,2010,1736255,2074833,3811088
Bosnia and Herzegovina,BIH,2011,1717279,2025863,3743142
Bosnia and Herzegovina,BIH,2012,1697524,1976850,3674374
Bosnia and Herzegovina,BIH,2013,1682852,1934707,3617559
Bosnia and Herzegovina,BIH,2014,1672688,1898380,3571068
Bosnia and Herzegovina,BIH,2015,1662529,1861795,3524324
Bosnia and Herzegovina,BIH,2016,1654095,1826891,3480986
Bosnia and Herzegovina,BIH,2017,1646947,1793080,3440027
Bosnia and Herzegovina,BIH,2018,1640392,1759737,3400129
Bosnia and Herzegovina,BIH,2019,1634179,1726532,3360711
Bosnia and Herzegovina,BIH,2020,1626683,1691724,3318407
Bosnia and Herzegovina,BIH,2021,1616664,1654279,3270943
Botswana,BWA,1960,15694,497171,512865
Botswana,BWA,1961,16241,508162,524403
Botswana,BWA,1962,16812,519616,536428
Botswana,BWA,1963,17410,531631,549041
Botswana,BWA,1964,18656,543618,562274
Botswana,BWA,1965,21920,549055,570975
Botswana,BWA,1966,25506,549349,574855
Botswana,BWA,1967,29654,549069,578723
Botswana,BWA,1968,34447,548208,582655
Botswana,BWA,1969,39957,546780,586737
Botswana,BWA,1970,46396,545848,592244
Botswana,BWA,1971,54360,549779,604139
Botswana,BWA,1972,60749,565852,626601
Botswana,BWA,1973,68229,589017,657246
Botswana,BWA,1974,76833,614736,691569
Botswana,BWA,1975,86507,641423,727930
Botswana,BWA,1976,97374,669050,766424
Botswana,BWA,1977,109522,697446,806968
Botswana,BWA,1978,123069,726325,849394
Botswana,BWA,1979,138108,755392,893500
Botswana,BWA,1980,154668,783910,938578
Botswana,BWA,1981,172492,810255,982747
Botswana,BWA,1982,199374,823635,1023009
Botswana,BWA,1983,230420,830297,1060717
Botswana,BWA,1984,265329,833841,1099170
Botswana,BWA,1985,304307,834397,1138704
Botswana,BWA,1986,347682,831581,1179263
Botswana,BWA,1987,395409,824952,1220361
Botswana,BWA,1988,447335,813937,1261272
Botswana,BWA,1989,503070,798601,1301671
Botswana,BWA,1990,562520,778954,1341474
Botswana,BWA,1991,625294,755290,1380584
Botswana,BWA,1992,659813,760882,1420695
Botswana,BWA,1993,691445,770817,1462262
Botswana,BWA,1994,723701,779843,1503544
Botswana,BWA,1995,756087,787547,1543634
Botswana,BWA,1996,788395,793774,1582169
Botswana,BWA,1997,820640,798714,1619354
Botswana,BWA,1998,853099,802600,1655699
Botswana,BWA,1999,885903,805655,1691558
Botswana,BWA,2000,919084,807901,1726985
Botswana,BWA,2001,952535,809395,1761930
Botswana,BWA,2002,979602,815528,1795130
Botswana,BWA,2003,1005304,821559,1826863
Botswana,BWA,2004,1031569,827516,1859085
Botswana,BWA,2005,1058912,833895,1892807
Botswana,BWA,2006,1087789,840915,1928704
Botswana,BWA,2007,1139430,827547,1966977
Botswana,BWA,2008,1193231,814089,2007320
Botswana,BWA,2009,1248597,800400,2048997
Botswana,BWA,2010,1305449,786215,2091664
Botswana,BWA,2011,1362903,771134,2134037
Botswana,BWA,2012,1408979,766446,2175425
Botswana,BWA,2013,1453914,763364,2217278
Botswana,BWA,2014,1500166,760210,2260376
Botswana,BWA,2015,1548038,757133,2305171
Botswana,BWA,2016,1598067,754349,2352416
Botswana,BWA,2017,1650064,751776,2401840
Botswana,BWA,2018,1702405,749004,2451409
Botswana,BWA,2019,1754091,745611,2499702
Botswana,BWA,2020,1804813,741589,2546402
Botswana,BWA,2021,1852275,736148,2588423
Brazil,BRA,1960,33724155,39368360,73092515
Brazil,BRA,1961,35497006,39833000,75330006
Brazil,BRA,1962,37324448,40274770,77599218
Brazil,BRA,1963,39220956,40694600,79915556
Brazil,BRA,1964,41179932,41082864,82262796
Brazil,BRA,1965,43189422,41434324,84623746
Brazil,BRA,1966,45243144,41736140,86979284
Brazil,BRA,1967,47335090,41988200,89323290
Brazil,BRA,1968,49468495,42190750,91659245
Brazil,BRA,1969,51643809,42356572,94000381
Brazil,BRA,1970,53879433,42490440,96369873
Brazil,BRA,1971,56192092,42574196,98766288
Brazil,BRA,1972,58570303,42624092,101194395
Brazil,BRA,1973,61013156,42653748,103666904
Brazil,BRA,1974,63515692,42651680,106167372
Brazil,BRA,1975,66077956,42622560,108700516
Brazil,BRA,1976,68713852,42572652,111286504
Brazil,BRA,1977,71427775,42512110,113939885
Brazil,BRA,1978,74227713,42436668,116664381
Brazil,BRA,1979,77104429,42342870,119447299
Brazil,BRA,1980,80059759,42228624,122288383
Brazil,BRA,1981,83074041,42094020,125168061
Brazil,BRA,1982,86139144,41925950,128065094
Brazil,BRA,1983,89250599,41726772,130977371
Brazil,BRA,1984,92396644,41492132,133888776
Brazil,BRA,1985,95559465,41223716,136783181
Brazil,BRA,1986,98732041,40911310,139643351
Brazil,BRA,1987,101904694,40561570,142466264
Brazil,BRA,1988,105079629,40174344,145253973
Brazil,BRA,1989,108248215,39755196,148003411
Brazil,BRA,1990,111405219,39301228,150706447
Brazil,BRA,1991,114526991,38809456,153336447
Brazil,BRA,1992,117617792,38283000,155900792
Brazil,BRA,1993,120701843,37739030,158440873
Brazil,BRA,1994,123798812,37181660,160980472
Brazil,BRA,1995,126904246,36611080,163515326
Brazil,BRA,1996,130010387,36026736,166037123
Brazil,BRA,1997,133232801,35313904,168546705
Brazil,BRA,1998,136457266,34582536,171039802
Brazil,BRA,1999,139649517,33836764,173486281
Brazil,BRA,2000,142795391,33078328,175873719
Brazil,BRA,2001,145337135,32874746,178211881
Brazil,BRA,2002,147774310,32702376,180476686
Brazil,BRA,2003,150126745,32502532,182629277
Brazil,BRA,2004,152434477,32287566,184722043
Brazil,BRA,2005,154731704,32065630,186797334
Brazil,BRA,2006,156991180,31829502,188820682
Brazil,BRA,2007,159201638,31577816,190779454
Brazil,BRA,2008,161361139,31311178,192672317
Brazil,BRA,2009,163480329,31037220,194517549
Brazil,BRA,2010,165594717,30758776,196353493
Brazil,BRA,2011,167726203,30459100,198185303
Brazil,BRA,2012,169827068,30150640,199977708
Brazil,BRA,2013,171885100,29836668,201721768
Brazil,BRA,2014,173941724,29517926,203459650
Brazil,BRA,2015,175989923,29198282,205188205
Brazil,BRA,2016,177986118,28873460,206859578
Brazil,BRA,2017,179958546,28546414,208504960
Brazil,BRA,2018,181939117,28227476,210166593
Brazil,BRA,2019,183878366,27904512,211782878
Brazil,BRA,2020,185636418,27559886,213196304
Brazil,BRA,2021,187143228,27182996,214326224
British Virgin Islands,VGB,1960,960,6890,7850
British Virgin Islands,VGB,1961,995,6890,7885
British Virgin Islands,VGB,1962,1029,6873,7902
British Virgin Islands,VGB,1963,1064,6855,7919
British Virgin Islands,VGB,1964,1101,6848,7949
British Virgin Islands,VGB,1965,1146,6872,8018
British Virgin Islands,VGB,1966,1199,6940,8139
British Virgin Islands,VGB,1967,1266,7071,8337
British Virgin Islands,VGB,1968,1354,7295,8649
British Virgin Islands,VGB,1969,1471,7646,9117
British Virgin Islands,VGB,1970,1594,7987,9581
British Virgin Islands,VGB,1971,1685,8128,9813
British Virgin Islands,VGB,1972,1756,8151,9907
British Virgin Islands,VGB,1973,1833,8185,10018
British Virgin Islands,VGB,1974,1915,8231,10146
British Virgin Islands,VGB,1975,2002,8280,10282
British Virgin Islands,VGB,1976,2094,8334,10428
British Virgin Islands,VGB,1977,2190,8388,10578
British Virgin Islands,VGB,1978,2289,8438,10727
British Virgin Islands,VGB,1979,2392,8484,10876
British Virgin Islands,VGB,1980,2526,8583,11109
British Virgin Islands,VGB,1981,2758,8714,11472
British Virgin Islands,VGB,1982,3018,8871,11889
British Virgin Islands,VGB,1983,3299,9016,12315
British Virgin Islands,VGB,1984,3601,9152,12753
British Virgin Islands,VGB,1985,3925,9277,13202
British Virgin Islands,VGB,1986,4270,9386,13656
British Virgin Islands,VGB,1987,4637,9480,14117
British Virgin Islands,VGB,1988,5030,9563,14593
British Virgin Islands,VGB,1989,5451,9640,15091
British Virgin Islands,VGB,1990,5905,9712,15617
British Virgin Islands,VGB,1991,6329,9761,16090
British Virgin Islands,VGB,1992,6525,9951,16476
British Virgin Islands,VGB,1993,6720,10135,16855
British Virgin Islands,VGB,1994,6927,10328,17255
British Virgin Islands,VGB,1995,7143,10531,17674
British Virgin Islands,VGB,1996,7372,10748,18120
British Virgin Islands,VGB,1997,7614,10977,18591
British Virgin Islands,VGB,1998,7866,11213,19079
British Virgin Islands,VGB,1999,8128,11458,19586
British Virgin Islands,VGB,2000,8398,11706,20104
British Virgin Islands,VGB,2001,8686,11971,20657
British Virgin Islands,VGB,2002,9011,12277,21288
British Virgin Islands,VGB,2003,9368,12614,21982
British Virgin Islands,VGB,2004,9747,12968,22715
British Virgin Islands,VGB,2005,10153,13344,23497
British Virgin Islands,VGB,2006,10585,13738,24323
British Virgin Islands,VGB,2007,11041,14150,25191
British Virgin Islands,VGB,2008,11530,14585,26115
British Virgin Islands,VGB,2009,12029,15015,27044
British Virgin Islands,VGB,2010,12349,15207,27556
British Virgin Islands,VGB,2011,12626,15336,27962
British Virgin Islands,VGB,2012,12932,15489,28421
British Virgin Islands,VGB,2013,13141,15516,28657
British Virgin Islands,VGB,2014,13389,15582,28971
British Virgin Islands,VGB,2015,13680,15686,29366
British Virgin Islands,VGB,2016,13965,15774,29739
British Virgin Islands,VGB,2017,14230,15830,30060
British Virgin Islands,VGB,2018,14477,15858,30335
British Virgin Islands,VGB,2019,14728,15882,30610
British Virgin Islands,VGB,2020,14996,15914,30910
British Virgin Islands,VGB,2021,15225,15897,31122
Brunei,BRN,1960,37041,48305,85346
Brunei,BRN,1961,40507,49054,89561
Brunei,BRN,1962,44169,49668,93837
Brunei,BRN,1963,48077,50200,98277
Brunei,BRN,1964,52251,50653,102904
Brunei,BRN,1965,56670,51016,107686
Brunei,BRN,1966,61330,51267,112597
Brunei,BRN,1967,66225,51403,117628
Brunei,BRN,1968,71348,51416,122764
Brunei,BRN,1969,76689,51323,128012
Brunei,BRN,1970,82239,51104,133343
Brunei,BRN,1971,87931,50735,138666
Brunei,BRN,1972,91707,52179,143886
Brunei,BRN,1973,95236,53829,149065
Brunei,BRN,1974,98824,55490,154314
Brunei,BRN,1975,102486,57167,159653
Brunei,BRN,1976,106210,58854,165064
Brunei,BRN,1977,110004,60556,170560
Brunei,BRN,1978,113892,62284,176176
Brunei,BRN,1979,117901,64050,181951
Brunei,BRN,1980,122053,65868,187921
Brunei,BRN,1981,126357,67742,194099
Brunei,BRN,1982,130909,69721,200630
Brunei,BRN,1983,135718,71805,207523
Brunei,BRN,1984,140720,73962,214682
Brunei,BRN,1985,145926,76193,222119
Brunei,BRN,1986,151324,78491,229815
Brunei,BRN,1987,156876,80836,237712
Brunei,BRN,1988,162533,83196,245729
Brunei,BRN,1989,168258,85563,253821
Brunei,BRN,1990,174020,87908,261928
Brunei,BRN,1991,179686,90174,269860
Brunei,BRN,1992,186085,91331,277416
Brunei,BRN,1993,192477,92236,284713
Brunei,BRN,1994,198884,93051,291935
Brunei,BRN,1995,205312,93785,299097
Brunei,BRN,1996,211759,94437,306196
Brunei,BRN,1997,218204,95011,313215
Brunei,BRN,1998,224651,95501,320152
Brunei,BRN,1999,231119,95926,327045
Brunei,BRN,2000,237635,96291,333926
Brunei,BRN,2001,244153,96595,340748
Brunei,BRN,2002,250333,97130,347463
Brunei,BRN,2003,256403,97642,354045
Brunei,BRN,2004,262394,98067,360461
Brunei,BRN,2005,268301,98416,366717
Brunei,BRN,2006,274122,98686,372808
Brunei,BRN,2007,279864,98884,378748
Brunei,BRN,2008,285549,99019,384568
Brunei,BRN,2009,291203,99108,390311
Brunei,BRN,2010,296885,99168,396053
Brunei,BRN,2011,302374,99132,401506
Brunei,BRN,2012,307643,98991,406634
Brunei,BRN,2013,312881,98821,411702
Brunei,BRN,2014,318042,98614,416656
Brunei,BRN,2015,323086,98351,421437
Brunei,BRN,2016,327973,98021,425994
Brunei,BRN,2017,332655,97621,430276
Brunei,BRN,2018,337123,97151,434274
Brunei,BRN,2019,341423,96625,438048
Brunei,BRN,2020,345650,96075,441725
Brunei,BRN,2021,349858,95515,445373
Bulgaria,BGR,1960,2918796,4948578,7867374
Bulgaria,BGR,1961,3080500,4862618,7943118
Bulgaria,BGR,1962,3244762,4768184,8012946
Bulgaria,BGR,1963,3411401,4666744,8078145
Bulgaria,BGR,1964,3582451,4561889,8144340
Bulgaria,BGR,1965,3753817,4450351,8204168
Bulgaria,BGR,1966,3900528,4357529,8258057
Bulgaria,BGR,1967,4030377,4279849,8310226
Bulgaria,BGR,1968,4165384,4204219,8369603
Bulgaria,BGR,1969,4304295,4129877,8434172
Bulgaria,BGR,1970,4440047,4049527,8489574
Bulgaria,BGR,1971,4555020,3981375,8536395
Bulgaria,BGR,1972,4667082,3909118,8576200
Bulgaria,BGR,1973,4782137,3838830,8620967
Bulgaria,BGR,1974,4905140,3773605,8678745
Bulgaria,BGR,1975,5019834,3700908,8720742
Bulgaria,BGR,1976,5126058,3632541,8758599
Bulgaria,BGR,1977,5232150,3572033,8804183
Bulgaria,BGR,1978,5317153,3496879,8814032
Bulgaria,BGR,1979,5402887,3423053,8825940
Bulgaria,BGR,1980,5503013,3358522,8861535
Bulgaria,BGR,1981,5566106,3325011,8891117
Bulgaria,BGR,1982,5627272,3290185,8917457
Bulgaria,BGR,1983,5685942,3253796,8939738
Bulgaria,BGR,1984,5743706,3216973,8960679
Bulgaria,BGR,1985,5787617,3172930,8960547
Bulgaria,BGR,1986,5822722,3135449,8958171
Bulgaria,BGR,1987,5862424,3108935,8971359
Bulgaria,BGR,1988,5900092,3081354,8981446
Bulgaria,BGR,1989,5861908,3015064,8876972
Bulgaria,BGR,1990,5786939,2931350,8718289
Bulgaria,BGR,1991,5759256,2873111,8632367
Bulgaria,BGR,1992,5726692,2813472,8540164
Bulgaria,BGR,1993,5704408,2767905,8472313
Bulgaria,BGR,1994,5704237,2739354,8443591
Bulgaria,BGR,1995,5697800,2708267,8406067
Bulgaria,BGR,1996,5687307,2675519,8362826
Bulgaria,BGR,1997,5671407,2640661,8312068
Bulgaria,BGR,1998,5652100,2604686,8256786
Bulgaria,BGR,1999,5638810,2571814,8210624
Bulgaria,BGR,2000,5629167,2541005,8170172
Bulgaria,BGR,2001,5539603,2469539,8009142
Bulgaria,BGR,2002,5448708,2388453,7837161
Bulgaria,BGR,2003,5433321,2342006,7775327
Bulgaria,BGR,2004,5419782,2297078,7716860
Bulgaria,BGR,2005,5406009,2252963,7658972
Bulgaria,BGR,2006,5391557,2209465,7601022
Bulgaria,BGR,2007,5378166,2167172,7545338
Bulgaria,BGR,2008,5366322,2126239,7492561
Bulgaria,BGR,2009,5357245,2087198,7444443
Bulgaria,BGR,2010,5347166,2048433,7395599
Bulgaria,BGR,2011,5337678,2010650,7348328
Bulgaria,BGR,2012,5331472,1974416,7305888
Bulgaria,BGR,2013,5326274,1938841,7265115
Bulgaria,BGR,2014,5320503,1903435,7223938
Bulgaria,BGR,2015,5310996,1866995,7177991
Bulgaria,BGR,2016,5298039,1829783,7127822
Bulgaria,BGR,2017,5283539,1792408,7075947
Bulgaria,BGR,2018,5269340,1755697,7025037
Bulgaria,BGR,2019,5256027,1719734,6975761
Bulgaria,BGR,2020,5248079,1685936,6934015
Bulgaria,BGR,2021,5228804,1648939,6877743
Burkina Faso,BFA,1960,224813,4558446,4783259
Burkina Faso,BFA,1961,232742,4620091,4852833
Burkina Faso,BFA,1962,240956,4683541,4924497
Burkina Faso,BFA,1963,249584,4749087,4998671
Burkina Faso,BFA,1964,258628,4817483,5076111
Burkina Faso,BFA,1965,268109,4889820,5157929
Burkina Faso,BFA,1966,278026,4964771,5242797
Burkina Faso,BFA,1967,288439,5042174,5330613
Burkina Faso,BFA,1968,299301,5122818,5422119
Burkina Faso,BFA,1969,310647,5205100,5515747
Burkina Faso,BFA,1970,322446,5289220,5611666
Burkina Faso,BFA,1971,334534,5373259,5707793
Burkina Faso,BFA,1972,347156,5458127,5805283
Burkina Faso,BFA,1973,360372,5547370,5907742
Burkina Faso,BFA,1974,374449,5643692,6018141
Burkina Faso,BFA,1975,389607,5748837,6138444
Burkina Faso,BFA,1976,418068,5851697,6269765
Burkina Faso,BFA,1977,458849,5957720,6416569
Burkina Faso,BFA,1978,504384,6073395,6577779
Burkina Faso,BFA,1979,554710,6195229,6749939
Burkina Faso,BFA,1980,610448,6322519,6932967
Burkina Faso,BFA,1981,671625,6452105,7123730
Burkina Faso,BFA,1982,738845,6582972,7321817
Burkina Faso,BFA,1983,813067,6718117,7531184
Burkina Faso,BFA,1984,894830,6856646,7751476
Burkina Faso,BFA,1985,984153,6995032,7979185
Burkina Faso,BFA,1986,1053228,7154599,8207827
Burkina Faso,BFA,1987,1102623,7332373,8434996
Burkina Faso,BFA,1988,1153661,7510059,8663720
Burkina Faso,BFA,1989,1206461,7688773,8895234
Burkina Faso,BFA,1990,1261498,7869863,9131361
Burkina Faso,BFA,1991,1317665,8047399,9365064
Burkina Faso,BFA,1992,1375473,8223082,9598555
Burkina Faso,BFA,1993,1435962,8404113,9840075
Burkina Faso,BFA,1994,1499561,8591695,10091256
Burkina Faso,BFA,1995,1566552,8786711,10353263
Burkina Faso,BFA,1996,1636410,8984800,10621210
Burkina Faso,BFA,1997,1729955,9167398,10897353
Burkina Faso,BFA,1998,1849296,9351767,11201063
Burkina Faso,BFA,1999,1979850,9553704,11533554
Burkina Faso,BFA,2000,2120383,9762505,11882888
Burkina Faso,BFA,2001,2271106,9978658,12249764
Burkina Faso,BFA,2002,2432722,10199547,12632269
Burkina Faso,BFA,2003,2605597,10424994,13030591
Burkina Faso,BFA,2004,2790981,10654996,13445977
Burkina Faso,BFA,2005,2988501,10887626,13876127
Burkina Faso,BFA,2006,3198105,11118137,14316242
Burkina Faso,BFA,2007,3393537,11363537,14757074
Burkina Faso,BFA,2008,3576677,11621238,15197915
Burkina Faso,BFA,2009,3768369,11881653,15650022
Burkina Faso,BFA,2010,3970062,12146783,16116845
Burkina Faso,BFA,2011,4183204,12419447,16602651
Burkina Faso,BFA,2012,4409695,12704037,17113732
Burkina Faso,BFA,2013,4646488,12989920,17636408
Burkina Faso,BFA,2014,4893865,13275977,18169842
Burkina Faso,BFA,2015,5153071,13564948,18718019
Burkina Faso,BFA,2016,5422969,13852529,19275498
Burkina Faso,BFA,2017,5701421,14134437,19835858
Burkina Faso,BFA,2018,5986896,14405827,20392723
Burkina Faso,BFA,2019,6281301,14670338,20951639
Burkina Faso,BFA,2020,6587430,14935196,21522626
Burkina Faso,BFA,2021,6904253,15196430,22100683
Burundi,BDI,1960,57047,2689581,2746628
Burundi,BDI,1961,59558,2756414,2815972
Burundi,BDI,1962,62195,2825203,2887398
Burundi,BDI,1963,64653,2883480,2948133
Burundi,BDI,1964,67732,2965489,3033221
Burundi,BDI,1965,71530,3046604,3118134
Burundi,BDI,1966,76481,3116897,3193378
Burundi,BDI,1967,81895,3192598,3274493
Burundi,BDI,1968,87531,3264866,3352397
Burundi,BDI,1969,93350,3331079,3424429
Burundi,BDI,1970,99513,3398321,3497834
Burundi,BDI,1971,106387,3475683,3582070
Burundi,BDI,1972,110991,3468204,3579195
Burundi,BDI,1973,115572,3455878,3571450
Burundi,BDI,1974,123599,3536433,3660032
Burundi,BDI,1975,132160,3617072,3749232
Burundi,BDI,1976,140900,3689989,3830889
Burundi,BDI,1977,150735,3776693,3927428
Burundi,BDI,1978,161778,3877632,4039410
Burundi,BDI,1979,172862,3964575,4137437
Burundi,BDI,1980,187134,4125700,4312834
Burundi,BDI,1981,202218,4288525,4490743
Burundi,BDI,1982,215110,4387161,4602271
Burundi,BDI,1983,229236,4497270,4726506
Burundi,BDI,1984,243711,4598557,4842268
Burundi,BDI,1985,258336,4689688,4948024
Burundi,BDI,1986,273109,4768597,5041706
Burundi,BDI,1987,289867,4867902,5157769
Burundi,BDI,1988,307348,4964492,5271840
Burundi,BDI,1989,324947,5048750,5373697
Burundi,BDI,1990,343889,5139904,5483793
Burundi,BDI,1991,361146,5233682,5594828
Burundi,BDI,1992,381169,5361916,5743085
Burundi,BDI,1993,379033,5176187,5555220
Burundi,BDI,1994,391831,5194577,5586408
Burundi,BDI,1995,427813,5504970,5932783
Burundi,BDI,1996,439569,5490938,5930507
Burundi,BDI,1997,451280,5472582,5923862
Burundi,BDI,1998,472567,5562773,6035340
Burundi,BDI,1999,496639,5683541,6180180
Burundi,BDI,2000,520130,5787529,6307659
Burundi,BDI,2001,547065,5918664,6465729
Burundi,BDI,2002,577261,6071677,6648938
Burundi,BDI,2003,611164,6249682,6860846
Burundi,BDI,2004,650742,6469754,7120496
Burundi,BDI,2005,692707,6696167,7388874
Burundi,BDI,2006,736488,6921702,7658190
Burundi,BDI,2007,783656,7160953,7944609
Burundi,BDI,2008,837579,7440530,8278109
Burundi,BDI,2009,903684,7805682,8709366
Burundi,BDI,2010,971253,8155352,9126605
Burundi,BDI,2011,1032093,8423640,9455733
Burundi,BDI,2012,1096506,8698973,9795479
Burundi,BDI,2013,1165374,8984203,10149577
Burundi,BDI,2014,1235881,9259032,10494913
Burundi,BDI,2015,1295625,9431523,10727148
Burundi,BDI,2016,1350704,9552623,10903327
Burundi,BDI,2017,1417430,9738163,11155593
Burundi,BDI,2018,1497829,9995643,11493472
Burundi,BDI,2019,1587191,10287647,11874838
Burundi,BDI,2020,1675149,10545078,12220227
Burundi,BDI,2021,1764450,10786763,12551213
Cambodia,KHM,1960,569961,4971715,5541676
Cambodia,KHM,1961,583063,5081591,5664654
Cambodia,KHM,1962,598162,5190692,5788854
Cambodia,KHM,1963,620759,5292921,5913680
Cambodia,KHM,1964,644075,5396772,6040847
Cambodia,KHM,1965,668290,5502437,6170727
Cambodia,KHM,1966,692915,5606315,6299230
Cambodia,KHM,1967,777471,5648974,6426445
Cambodia,KHM,1968,870974,5682135,6553109
Cambodia,KHM,1969,973835,5705873,6679708
Cambodia,KHM,1970,1071351,5637174,6708525
Cambodia,KHM,1971,1253351,5442973,6696324
Cambodia,KHM,1972,1476269,5290020,6766289
Cambodia,KHM,1973,1731112,5121248,6852360
Cambodia,KHM,1974,2008691,4904717,6913408
Cambodia,KHM,1975,301209,6426713,6727922
Cambodia,KHM,1976,304003,6003119,6307122
Cambodia,KHM,1977,313245,5726952,6040197
Cambodia,KHM,1978,332515,5628678,5961193
Cambodia,KHM,1979,363048,5688760,6051808
Cambodia,KHM,1980,613573,5585386,6198959
Cambodia,KHM,1981,810961,5553511,6364472
Cambodia,KHM,1982,862613,5757086,6619699
Cambodia,KHM,1983,917021,5964941,6881962
Cambodia,KHM,1984,972065,6161834,7133899
Cambodia,KHM,1985,1027563,6348527,7376090
Cambodia,KHM,1986,1091125,6570192,7661317
Cambodia,KHM,1987,1161167,6814430,7975597
Cambodia,KHM,1988,1230791,7038989,8269780
Cambodia,KHM,1989,1303724,7267204,8570928
Cambodia,KHM,1990,1385274,7525534,8910808
Cambodia,KHM,1991,1471035,7788327,9259362
Cambodia,KHM,1992,1577655,8140560,9718215
Cambodia,KHM,1993,1699098,8544452,10243550
Cambodia,KHM,1994,1802436,8833917,10636353
Cambodia,KHM,1995,1890279,9029249,10919528
Cambodia,KHM,1996,1977421,9205191,11182612
Cambodia,KHM,1997,2064541,9367028,11431569
Cambodia,KHM,1998,2141859,9527218,11669077
Cambodia,KHM,1999,2197746,9701260,11899006
Cambodia,KHM,2000,2252408,9866433,12118841
Cambodia,KHM,2001,2307612,10030580,12338192
Cambodia,KHM,2002,2364127,10197652,12561779
Cambodia,KHM,2003,2421609,10366101,12787710
Cambodia,KHM,2004,2480269,10536102,13016371
Cambodia,KHM,2005,2539900,10706683,13246583
Cambodia,KHM,2006,2600268,10877511,13477779
Cambodia,KHM,2007,2662452,11052339,13714791
Cambodia,KHM,2008,2728958,11214930,13943888
Cambodia,KHM,2009,2821239,11334501,14155740
Cambodia,KHM,2010,2914935,11448597,14363532
Cambodia,KHM,2011,3011402,11562483,14573885
Cambodia,KHM,2012,3110665,11675975,14786640
Cambodia,KHM,2013,3212182,11787501,14999683
Cambodia,KHM,2014,3315806,11895011,15210817
Cambodia,KHM,2015,3420840,11996683,15417523
Cambodia,KHM,2016,3528344,12096240,15624584
Cambodia,KHM,2017,3637892,12192797,15830689
Cambodia,KHM,2018,3747983,12277255,16025238
Cambodia,KHM,2019,3858254,12349492,16207746
Cambodia,KHM,2020,3973287,12423573,16396860
Cambodia,KHM,2021,4092180,12496843,16589023
Cameroon,CMR,1960,713241,4404367,5117608
Cameroon,CMR,1961,753427,4446928,5200355
Cameroon,CMR,1962,798652,4505189,5303841
Cameroon,CMR,1963,849243,4578268,5427511
Cameroon,CMR,1964,903162,4653047,5556209
Cameroon,CMR,1965,960487,4729599,5690086
Cameroon,CMR,1966,1021634,4807946,5829580
Cameroon,CMR,1967,1086868,4888219,5975087
Cameroon,CMR,1968,1156508,4970685,6127193
Cameroon,CMR,1969,1230656,5055576,6286232
Cameroon,CMR,1970,1309916,5142871,6452787
Cameroon,CMR,1971,1430447,5196903,6627350
Cameroon,CMR,1972,1561207,5248261,6809468
Cameroon,CMR,1973,1702361,5296327,6998688
Cameroon,CMR,1974,1854793,5339904,7194697
Cameroon,CMR,1975,2018903,5378514,7397417
Cameroon,CMR,1976,2178962,5419066,7598028
Cameroon,CMR,1977,2297646,5499179,7796825
Cameroon,CMR,1978,2425940,5587339,8013279
Cameroon,CMR,1979,2562948,5680429,8243377
Cameroon,CMR,1980,2719634,5800257,8519891
Cameroon,CMR,1981,2892484,5936564,8829048
Cameroon,CMR,1982,3040963,6006023,9046986
Cameroon,CMR,1983,3185814,6054858,9240672
Cameroon,CMR,1984,3361279,6147291,9508570
Cameroon,CMR,1985,3552277,6251977,9804254
Cameroon,CMR,1986,3754243,6358469,10112712
Cameroon,CMR,1987,3958728,6475177,10433905
Cameroon,CMR,1988,4143619,6615954,10759573
Cameroon,CMR,1989,4333890,6755332,11089222
Cameroon,CMR,1990,4533001,6897519,11430520
Cameroon,CMR,1991,4738765,7038954,11777719
Cameroon,CMR,1992,4950532,7178072,12128604
Cameroon,CMR,1993,5169399,7317374,12486773
Cameroon,CMR,1994,5394595,7454267,12848862
Cameroon,CMR,1995,5624594,7587053,13211647
Cameroon,CMR,1996,5859653,7715671,13575324
Cameroon,CMR,1997,6099964,7841217,13941181
Cameroon,CMR,1998,6348238,7966361,14314599
Cameroon,CMR,1999,6606306,8092667,14698973
Cameroon,CMR,2000,6873014,8218580,15091594
Cameroon,CMR,2001,7148432,8344821,15493253
Cameroon,CMR,2002,7437901,8476132,15914033
Cameroon,CMR,2003,7741811,8612515,16354326
Cameroon,CMR,2004,8058430,8750977,16809407
Cameroon,CMR,2005,8385541,8889630,17275171
Cameroon,CMR,2006,8723538,9027795,17751333
Cameroon,CMR,2007,9079573,9172293,18251866
Cameroon,CMR,2008,9454260,9322821,18777081
Cameroon,CMR,2009,9843943,9475331,19319274
Cameroon,CMR,2010,10248917,9629119,19878036
Cameroon,CMR,2011,10666950,9781923,20448873
Cameroon,CMR,2012,11098737,9933947,21032684
Cameroon,CMR,2013,11546101,10086749,21632850
Cameroon,CMR,2014,12036424,10263161,22299585
Cameroon,CMR,2015,12559842,10452804,23012646
Cameroon,CMR,2016,13083840,10627790,23711630
Cameroon,CMR,2017,13605785,10787396,24393181
Cameroon,CMR,2018,14136765,10939982,25076747
Cameroon,CMR,2019,14687684,11094657,25782341
Cameroon,CMR,2020,15248270,11242817,26491087
Cameroon,CMR,2021,15815458,11383170,27198628
Canada,CAN,1960,12368380,5540976,17909356
Canada,CAN,1961,12729040,5541960,18271000
Canada,CAN,1962,13121753,5492247,18614000
Canada,CAN,1963,13522659,5441341,18964000
Canada,CAN,1964,13934678,5390322,19325000
Canada,CAN,1965,14343688,5334312,19678000
Canada,CAN,1966,14763748,5284252,20048000
Canada,CAN,1967,15136519,5275481,20412000
Canada,CAN,1968,15487885,5256115,20744000
Canada,CAN,1969,15804855,5223145,21028000
Canada,CAN,1970,16132459,5191541,21324000
Canada,CAN,1971,16710910,5251122,21962032
Canada,CAN,1972,16879589,5338874,22218463
Canada,CAN,1973,17060238,5431539,22491777
Canada,CAN,1974,17272703,5535266,22807969
Canada,CAN,1975,17498862,5644413,23143275
Canada,CAN,1976,17705309,5744499,23449808
Canada,CAN,1977,17923214,5802629,23725843
Canada,CAN,1978,18112108,5851095,23963203
Canada,CAN,1979,18301934,5899610,24201544
Canada,CAN,1980,18549289,5966378,24515667
Canada,CAN,1981,18791654,6028261,24819915
Canada,CAN,1982,19057229,6059713,25116942
Canada,CAN,1983,19287381,6079070,25366451
Canada,CAN,1984,19511294,6095759,25607053
Canada,CAN,1985,19731489,6110627,25842116
Canada,CAN,1986,19967235,6133043,26100278
Canada,CAN,1987,20237468,6209133,26446601
Canada,CAN,1988,20506939,6284808,26791747
Canada,CAN,1989,20883649,6393132,27276781
Canada,CAN,1990,21206427,6484711,27691138
Canada,CAN,1991,21482271,6555149,28037420
Canada,CAN,1992,21813814,6557450,28371264
Canada,CAN,1993,22130869,6553895,28684764
Canada,CAN,1994,22450573,6550090,29000663
Canada,CAN,1995,22760570,6541741,29302311
Canada,CAN,1996,23081461,6528757,29610218
Canada,CAN,1997,23428320,6477628,29905948
Canada,CAN,1998,23739358,6415815,30155173
Canada,CAN,1999,24048329,6352957,30401286
Canada,CAN,2000,24388404,6297326,30685730
Canada,CAN,2001,24757782,6263120,31020902
Canada,CAN,2002,25052940,6307139,31360079
Canada,CAN,2003,25304780,6339248,31644028
Canada,CAN,2004,25566897,6373758,31940655
Canada,CAN,2005,25834340,6409413,32243753
Canada,CAN,2006,26126316,6444858,32571174
Canada,CAN,2007,26441461,6447564,32889025
Canada,CAN,2008,26789863,6457255,33247118
Canada,CAN,2009,27158023,6470872,33628895
Canada,CAN,2010,27522537,6482352,34004889
Canada,CAN,2011,27847821,6491507,34339328
Canada,CAN,2012,28166078,6548144,34714222
Canada,CAN,2013,28479640,6603314,35082954
Canada,CAN,2014,28781576,6655859,35437435
Canada,CAN,2015,29011826,6691082,35702908
Canada,CAN,2016,29357013,6752474,36109487
Canada,CAN,2017,29729549,6815687,36545236
Canada,CAN,2018,30175056,6890028,37065084
Canada,CAN,2019,30638234,6962996,37601230
Canada,CAN,2020,31023904,7013300,38037204
Canada,CAN,2021,31229095,7017013,38246108
Cape Verde,CPV,1960,35001,174848,209849
Cape Verde,CPV,1961,36402,178386,214788
Cape Verde,CPV,1962,38148,183336,221484
Cape Verde,CPV,1963,40049,188765,228814
Cape Verde,CPV,1964,42042,194320,236362
Cape Verde,CPV,1965,44126,200030,244156
Cape Verde,CPV,1966,46318,205920,252238
Cape Verde,CPV,1967,48629,212019,260648
Cape Verde,CPV,1968,51064,218344,269408
Cape Verde,CPV,1969,53630,224894,278524
Cape Verde,CPV,1970,56186,231076,287262
Cape Verde,CPV,1971,58407,235098,293505
Cape Verde,CPV,1972,60171,236647,296818
Cape Verde,CPV,1973,61780,237411,299191
Cape Verde,CPV,1974,63447,238235,301682
Cape Verde,CPV,1975,65194,239181,304375
Cape Verde,CPV,1976,66966,240049,307015
Cape Verde,CPV,1977,68712,240677,309389
Cape Verde,CPV,1978,70478,241207,311685
Cape Verde,CPV,1979,72282,241713,313995
Cape Verde,CPV,1980,74607,242627,317234
Cape Verde,CPV,1981,80392,241242,321634
Cape Verde,CPV,1982,86589,239730,326319
Cape Verde,CPV,1983,93112,237859,330971
Cape Verde,CPV,1984,99944,235529,335473
Cape Verde,CPV,1985,107060,232814,339874
Cape Verde,CPV,1986,116656,227615,344271
Cape Verde,CPV,1987,126776,221942,348718
Cape Verde,CPV,1988,137415,215818,353233
Cape Verde,CPV,1989,148647,209503,358150
Cape Verde,CPV,1990,160845,203718,364563
Cape Verde,CPV,1991,167888,204833,372721
Cape Verde,CPV,1992,175592,206355,381947
Cape Verde,CPV,1993,183738,208011,391749
Cape Verde,CPV,1994,192128,209527,401655
Cape Verde,CPV,1995,200623,210759,411382
Cape Verde,CPV,1996,209257,211750,421007
Cape Verde,CPV,1997,218070,212584,430654
Cape Verde,CPV,1998,227027,213187,440214
Cape Verde,CPV,1999,236077,213550,449627
Cape Verde,CPV,2000,244866,213385,458251
Cape Verde,CPV,2001,252973,212985,465958
Cape Verde,CPV,2002,260968,212263,473231
Cape Verde,CPV,2003,268835,211254,480089
Cape Verde,CPV,2004,276603,209980,486583
Cape Verde,CPV,2005,284307,208520,492827
Cape Verde,CPV,2006,291992,206892,498884
Cape Verde,CPV,2007,299625,205108,504733
Cape Verde,CPV,2008,307192,203144,510336
Cape Verde,CPV,2009,314622,201016,515638
Cape Verde,CPV,2010,322218,198994,521212
Cape Verde,CPV,2011,328762,198759,527521
Cape Verde,CPV,2012,335379,198485,533864
Cape Verde,CPV,2013,341874,198066,539940
Cape Verde,CPV,2014,348451,197625,546076
Cape Verde,CPV,2015,355043,197123,552166
Cape Verde,CPV,2016,361750,196644,558394
Cape Verde,CPV,2017,368695,196259,564954
Cape Verde,CPV,2018,375462,195740,571202
Cape Verde,CPV,2019,381965,195065,577030
Cape Verde,CPV,2020,388341,194299,582640
Cape Verde,CPV,2021,394509,193416,587925
Cayman Islands,CYM,1960,8473,0,8473
Cayman Islands,CYM,1961,8626,0,8626
Cayman Islands,CYM,1962,8799,0,8799
Cayman Islands,CYM,1963,8985,0,8985
Cayman Islands,CYM,1964,9172,0,9172
Cayman Islands,CYM,1965,9366,0,9366
Cayman Islands,CYM,1966,9566,0,9566
Cayman Islands,CYM,1967,9771,0,9771
Cayman Islands,CYM,1968,9981,0,9981
Cayman Islands,CYM,1969,10181,0,10181
Cayman Islands,CYM,1970,10533,0,10533
Cayman Islands,CYM,1971,11117,0,11117
Cayman Islands,CYM,1972,11778,0,11778
Cayman Islands,CYM,1973,12443,0,12443
Cayman Islands,CYM,1974,13118,0,13118
Cayman Islands,CYM,1975,13791,0,13791
Cayman Islands,CYM,1976,14456,0,14456
Cayman Islands,CYM,1977,15116,0,15116
Cayman Islands,CYM,1978,15746,0,15746
Cayman Islands,CYM,1979,16378,0,16378
Cayman Islands,CYM,1980,17100,0,17100
Cayman Islands,CYM,1981,17904,0,17904
Cayman Islands,CYM,1982,18729,0,18729
Cayman Islands,CYM,1983,19572,0,19572
Cayman Islands,CYM,1984,20433,0,20433
Cayman Islands,CYM,1985,21313,0,21313
Cayman Islands,CYM,1986,22195,0,22195
Cayman Islands,CYM,1987,23075,0,23075
Cayman Islands,CYM,1988,23956,0,23956
Cayman Islands,CYM,1989,24888,0,24888
Cayman Islands,CYM,1990,26027,0,26027
Cayman Islands,CYM,1991,27340,0,27340
Cayman Islands,CYM,1992,28677,0,28677
Cayman Islands,CYM,1993,30038,0,30038
Cayman Islands,CYM,1994,31418,0,31418
Cayman Islands,CYM,1995,32802,0,32802
Cayman Islands,CYM,1996,34194,0,34194
Cayman Islands,CYM,1997,35579,0,35579
Cayman Islands,CYM,1998,36947,0,36947
Cayman Islands,CYM,1999,38295,0,38295
Cayman Islands,CYM,2000,39658,0,39658
Cayman Islands,CYM,2001,41054,0,41054
Cayman Islands,CYM,2002,42456,0,42456
Cayman Islands,CYM,2003,43862,0,43862
Cayman Islands,CYM,2004,45286,0,45286
Cayman Islands,CYM,2005,46727,0,46727
Cayman Islands,CYM,2006,48177,0,48177
Cayman Islands,CYM,2007,49647,0,49647
Cayman Islands,CYM,2008,51123,0,51123
Cayman Islands,CYM,2009,52602,0,52602
Cayman Islands,CYM,2010,54074,0,54074
Cayman Islands,CYM,2011,55492,0,55492
Cayman Islands,CYM,2012,56860,0,56860
Cayman Islands,CYM,2013,58212,0,58212
Cayman Islands,CYM,2014,59559,0,59559
Cayman Islands,CYM,2015,60911,0,60911
Cayman Islands,CYM,2016,62255,0,62255
Cayman Islands,CYM,2017,63581,0,63581
Cayman Islands,CYM,2018,64884,0,64884
Cayman Islands,CYM,2019,66134,0,66134
Cayman Islands,CYM,2020,67311,0,67311
Cayman Islands,CYM,2021,68136,0,68136
Central African Republic,CAF,1960,337625,1342103,1679728
Central African Republic,CAF,1961,354918,1355446,1710364
Central African Republic,CAF,1962,373209,1369293,1742502
Central African Republic,CAF,1963,392543,1383671,1776214
Central African Republic,CAF,1964,413121,1398573,1811694
Central African Republic,CAF,1965,434907,1414264,1849171
Central African Republic,CAF,1966,458085,1430768,1888853
Central African Republic,CAF,1967,482715,1448146,1930861
Central African Republic,CAF,1968,509913,1465344,1975257
Central African Republic,CAF,1969,538634,1482885,2021519
Central African Republic,CAF,1970,568358,1498998,2067356
Central African Republic,CAF,1971,598659,1512565,2111224
Central African Republic,CAF,1972,629673,1523940,2153613
Central African Republic,CAF,1973,661692,1534213,2195905
Central African Republic,CAF,1974,695192,1544113,2239305
Central African Republic,CAF,1975,730194,1553733,2283927
Central African Republic,CAF,1976,755202,1563147,2318349
Central African Republic,CAF,1977,770464,1571584,2342048
Central African Republic,CAF,1978,785995,1579962,2365957
Central African Republic,CAF,1979,801860,1588469,2390329
Central African Republic,CAF,1980,818151,1597125,2415276
Central African Republic,CAF,1981,834874,1606136,2441010
Central African Republic,CAF,1982,852124,1615511,2467635
Central African Republic,CAF,1983,869891,1625206,2495097
Central African Republic,CAF,1984,888235,1635303,2523538
Central African Republic,CAF,1985,907159,1645916,2553075
Central African Republic,CAF,1986,926697,1656934,2583631
Central African Republic,CAF,1987,947002,1668592,2615594
Central African Republic,CAF,1988,971087,1686148,2657235
Central African Republic,CAF,1989,1000947,1723162,2724109
Central African Republic,CAF,1990,1034496,1774725,2809221
Central African Republic,CAF,1991,1069555,1828497,2898052
Central African Republic,CAF,1992,1106550,1885177,2991727
Central African Republic,CAF,1993,1145085,1944061,3089146
Central African Republic,CAF,1994,1184252,2003592,3187844
Central African Republic,CAF,1995,1219950,2056756,3276706
Central African Republic,CAF,1996,1255015,2108555,3363570
Central African Republic,CAF,1997,1293261,2165211,3458472
Central African Republic,CAF,1998,1332260,2222804,3555064
Central African Republic,CAF,1999,1372844,2282516,3655360
Central African Republic,CAF,2000,1414914,2344256,3759170
Central African Republic,CAF,2001,1450248,2394525,3844773
Central African Republic,CAF,2002,1485864,2444784,3930648
Central African Republic,CAF,2003,1525528,2501313,4026841
Central African Republic,CAF,2004,1562353,2552785,4115138
Central African Republic,CAF,2005,1602261,2606573,4208834
Central African Republic,CAF,2006,1640142,2654210,4294352
Central African Republic,CAF,2007,1677549,2698020,4375569
Central African Republic,CAF,2008,1720153,2747080,4467233
Central African Republic,CAF,2009,1766203,2798337,4564540
Central African Republic,CAF,2010,1812952,2847115,4660067
Central African Republic,CAF,2011,1851877,2880145,4732022
Central African Republic,CAF,2012,1880110,2893196,4773306
Central African Republic,CAF,2013,1904787,2897641,4802428
Central African Republic,CAF,2014,1917526,2881208,4798734
Central African Republic,CAF,2015,1941083,2878250,4819333
Central African Republic,CAF,2016,1991979,2912198,4904177
Central African Republic,CAF,2017,2047664,2949077,4996741
Central African Republic,CAF,2018,2107405,2987375,5094780
Central African Republic,CAF,2019,2175935,3033389,5209324
Central African Republic,CAF,2020,2254648,3088372,5343020
Central African Republic,CAF,2021,2327367,3129787,5457154
Chad,TCD,1960,202771,2825917,3028688
Chad,TCD,1961,214963,2872694,3087657
Chad,TCD,1962,227901,2920341,3148242
Chad,TCD,1963,241639,2968657,3210296
Chad,TCD,1964,257847,3015572,3273419
Chad,TCD,1965,280453,3055885,3336338
Chad,TCD,1966,304792,3093872,3398664
Chad,TCD,1967,331074,3130590,3461664
Chad,TCD,1968,359589,3167181,3526770
Chad,TCD,1969,390505,3204647,3595152
Chad,TCD,1970,424244,3243150,3667394
Chad,TCD,1971,460818,3281716,3742534
Chad,TCD,1972,500996,3323403,3824399
Chad,TCD,1973,543189,3369716,3912905
Chad,TCD,1974,588242,3412317,4000559
Chad,TCD,1975,635733,3448377,4084110
Chad,TCD,1976,685654,3477397,4163051
Chad,TCD,1977,738059,3500492,4238551
Chad,TCD,1978,793680,3519799,4313479
Chad,TCD,1979,818595,3584347,4402942
Chad,TCD,1980,828174,3580056,4408230
Chad,TCD,1981,836959,3572266,4409225
Chad,TCD,1982,886612,3736216,4622828
Chad,TCD,1983,941562,3917611,4859173
Chad,TCD,1984,963346,3957210,4920556
Chad,TCD,1985,982540,3985050,4967590
Chad,TCD,1986,1022762,4095398,5118160
Chad,TCD,1987,1070083,4230769,5300852
Chad,TCD,1988,1118211,4364827,5483038
Chad,TCD,1989,1168261,4502358,5670619
Chad,TCD,1990,1212671,4614398,5827069
Chad,TCD,1991,1270300,4772128,6042428
Chad,TCD,1992,1338426,4964500,6302926
Chad,TCD,1993,1380448,5067832,6448280
Chad,TCD,1994,1413539,5179459,6592998
Chad,TCD,1995,1479244,5409612,6888856
Chad,TCD,1996,1548495,5651796,7200291
Chad,TCD,1997,1604769,5846105,7450874
Chad,TCD,1998,1662933,6046182,7709115
Chad,TCD,1999,1724407,6257482,7981889
Chad,TCD,2000,1787029,6472108,8259137
Chad,TCD,2001,1850359,6688445,8538804
Chad,TCD,2002,1918103,6920266,8838369
Chad,TCD,2003,1998830,7197536,9196366
Chad,TCD,2004,2092667,7520836,9613503
Chad,TCD,2005,2181193,7823819,10005012
Chad,TCD,2006,2263228,8102386,10365614
Chad,TCD,2007,2344847,8377884,10722731
Chad,TCD,2008,2430718,8667946,11098664
Chad,TCD,2009,2521561,8974567,11496128
Chad,TCD,2010,2615056,9279671,11894727
Chad,TCD,2011,2716552,9601178,12317730
Chad,TCD,2012,2824191,9930715,12754906
Chad,TCD,2013,2940466,10276300,13216766
Chad,TCD,2014,3064321,10632805,13697126
Chad,TCD,2015,3183683,10956591,14140274
Chad,TCD,2016,3309161,11283424,14592585
Chad,TCD,2017,3448331,11637553,15085884
Chad,TCD,2018,3598175,12006035,15604210
Chad,TCD,2019,3754173,12372693,16126866
Chad,TCD,2020,3914834,12729867,16644701
Chad,TCD,2021,4085514,13094226,17179740
Channel Islands,OWID_CIS,1960,42255,66931,109186
Channel Islands,OWID_CIS,1961,42366,67859,110225
Channel Islands,OWID_CIS,1962,42478,68803,111281
Channel Islands,OWID_CIS,1963,42614,69796,112410
Channel Islands,OWID_CIS,1964,42764,70832,113596
Channel Islands,OWID_CIS,1965,42930,71902,114832
Channel Islands,OWID_CIS,1966,43107,73009,116116
Channel Islands,OWID_CIS,1967,43289,74141,117430
Channel Islands,OWID_CIS,1968,43452,75255,118707
Channel Islands,OWID_CIS,1969,43573,76311,119884
Channel Islands,OWID_CIS,1970,43668,77335,121003
Channel Islands,OWID_CIS,1971,43738,78424,122162
Channel Islands,OWID_CIS,1972,43658,79690,123348
Channel Islands,OWID_CIS,1973,43549,80916,124465
Channel Islands,OWID_CIS,1974,43399,82087,125486
Channel Islands,OWID_CIS,1975,43205,83188,126393
Channel Islands,OWID_CIS,1976,42922,84130,127052
Channel Islands,OWID_CIS,1977,42543,84882,127425
Channel Islands,OWID_CIS,1978,42120,85547,127667
Channel Islands,OWID_CIS,1979,41678,86172,127850
Channel Islands,OWID_CIS,1980,41222,86762,127984
Channel Islands,OWID_CIS,1981,41006,87504,128510
Channel Islands,OWID_CIS,1982,41334,88280,129614
Channel Islands,OWID_CIS,1983,41713,89168,130881
Channel Islands,OWID_CIS,1984,42092,90062,132154
Channel Islands,OWID_CIS,1985,42480,90970,133450
Channel Islands,OWID_CIS,1986,42886,91922,134808
Channel Islands,OWID_CIS,1987,43205,93059,136264
Channel Islands,OWID_CIS,1988,43536,94229,137765
Channel Islands,OWID_CIS,1989,43853,95375,139228
Channel Islands,OWID_CIS,1990,44137,96464,140601
Channel Islands,OWID_CIS,1991,44254,97303,141557
Channel Islands,OWID_CIS,1992,44131,97880,142011
Channel Islands,OWID_CIS,1993,43955,98336,142291
Channel Islands,OWID_CIS,1994,43746,98720,142466
Channel Islands,OWID_CIS,1995,43512,99047,142559
Channel Islands,OWID_CIS,1996,43441,99457,142898
Channel Islands,OWID_CIS,1997,43662,99887,143549
Channel Islands,OWID_CIS,1998,43886,100325,144211
Channel Islands,OWID_CIS,1999,44094,100717,144811
Channel Islands,OWID_CIS,2000,44267,101039,145306
Channel Islands,OWID_CIS,2001,44536,101508,146044
Channel Islands,OWID_CIS,2002,44970,102197,147167
Channel Islands,OWID_CIS,2003,45421,102920,148341
Channel Islands,OWID_CIS,2004,45880,103658,149538
Channel Islands,OWID_CIS,2005,46349,104414,150763
Channel Islands,OWID_CIS,2006,46819,105166,151985
Channel Islands,OWID_CIS,2007,47296,105929,153225
Channel Islands,OWID_CIS,2008,47778,106697,154475
Channel Islands,OWID_CIS,2009,48261,107460,155721
Channel Islands,OWID_CIS,2010,48734,108199,156933
Channel Islands,OWID_CIS,2011,49068,108751,157819
Channel Islands,OWID_CIS,2012,49266,109355,158621
Channel Islands,OWID_CIS,2013,49579,110215,159794
Channel Islands,OWID_CIS,2014,49875,111037,160912
Channel Islands,OWID_CIS,2015,50217,111973,162190
Channel Islands,OWID_CIS,2016,50639,113082,163721
Channel Islands,OWID_CIS,2017,51075,114140,165215
Channel Islands,OWID_CIS,2018,51706,115553,167259
Channel Islands,OWID_CIS,2019,52400,117010,169410
Channel Islands,OWID_CIS,2020,52982,118131,171113
Channel Islands,OWID_CIS,2021,53552,119131,172683
Chile,CHL,1960,5523085,2618735,8141820
Chile,CHL,1961,5708073,2605462,8313535
Chile,CHL,1962,5892337,2593783,8486120
Chile,CHL,1963,6076516,2579490,8656006
Chile,CHL,1964,6261811,2563235,8825046
Chile,CHL,1965,6449009,2545927,8994936
Chile,CHL,1966,6635508,2526141,9161649
Chile,CHL,1967,6821792,2504476,9326268
Chile,CHL,1968,7009854,2481648,9491502
Chile,CHL,1969,7198481,2457818,9656299
Chile,CHL,1970,7387653,2432828,9820481
Chile,CHL,1971,7576446,2407932,9984378
Chile,CHL,1972,7764351,2381414,10145765
Chile,CHL,1973,7953428,2354414,10307842
Chile,CHL,1974,8145490,2327253,10472743
Chile,CHL,1975,8339903,2299628,10639531
Chile,CHL,1976,8533902,2270967,10804869
Chile,CHL,1977,8728170,2241691,10969861
Chile,CHL,1978,8925346,2212402,11137748
Chile,CHL,1979,9122030,2182301,11304331
Chile,CHL,1980,9318432,2151396,11469828
Chile,CHL,1981,9517007,2120606,11637613
Chile,CHL,1982,9708759,2098649,11807408
Chile,CHL,1983,9863736,2112777,11976513
Chile,CHL,1984,10020929,2126829,12147758
Chile,CHL,1985,10184561,2141835,12326396
Chile,CHL,1986,10356376,2158126,12514502
Chile,CHL,1987,10536991,2175793,12712784
Chile,CHL,1988,10724071,2194318,12918389
Chile,CHL,1989,10915528,2213091,13128619
Chile,CHL,1990,11110740,2232128,13342868
Chile,CHL,1991,11310391,2251554,13561945
Chile,CHL,1992,11517039,2265258,13782297
Chile,CHL,1993,11744086,2254300,13998386
Chile,CHL,1994,11968656,2242018,14210674
Chile,CHL,1995,12188680,2228116,14416796
Chile,CHL,1996,12402845,2212638,14615483
Chile,CHL,1997,12613368,2195921,14809289
Chile,CHL,1998,12818765,2177977,14996742
Chile,CHL,1999,13018021,2158389,15176410
Chile,CHL,2000,13213754,2138045,15351799
Chile,CHL,2001,13406973,2117005,15523978
Chile,CHL,2002,13591764,2102026,15693790
Chile,CHL,2003,13744299,2114813,15859112
Chile,CHL,2004,13891581,2126385,16017966
Chile,CHL,2005,14037420,2137891,16175311
Chile,CHL,2006,14185272,2149303,16334575
Chile,CHL,2007,14334623,2160915,16495538
Chile,CHL,2008,14488641,2172821,16661462
Chile,CHL,2009,14647961,2185486,16833447
Chile,CHL,2010,14806204,2197958,17004162
Chile,CHL,2011,14963678,2209895,17173573
Chile,CHL,2012,15120117,2221654,17341771
Chile,CHL,2013,15276709,2233216,17509925
Chile,CHL,2014,15441376,2245732,17687108
Chile,CHL,2015,15611340,2258784,17870124
Chile,CHL,2016,15809289,2274590,18083879
Chile,CHL,2017,16070668,2297909,18368577
Chile,CHL,2018,16375738,2325712,18701450
Chile,CHL,2019,16686776,2352709,19039485
Chile,CHL,2020,16931587,2368728,19300315
Chile,CHL,2021,17118329,2374855,19493184
China,CHN,1960,108085352,558984640,667069992
China,CHN,1961,110327936,550002050,660329986
China,CHN,1962,114685540,551084500,665770040
China,CHN,1963,121162226,561172800,682335026
China,CHN,1964,127791981,570563000,698354981
China,CHN,1965,129348359,585836700,715185059
China,CHN,1966,131746910,603653100,735400010
China,CHN,1967,134196718,620353300,754550018
China,CHN,1968,136747486,637762500,774509986
China,CHN,1969,139527262,656497700,796024962
China,CHN,1970,142386810,675928200,818315010
China,CHN,1971,145443877,695661100,841104977
China,CHN,1972,148131235,713898750,862029985
China,CHN,1973,151552570,730387460,881940030
China,CHN,1974,155688522,744661500,900350022
China,CHN,1975,159452730,756942300,916395030
China,CHN,1976,162497601,768187400,930685001
China,CHN,1977,165293316,778161660,943454976
China,CHN,1978,171153535,785011460,956164995
China,CHN,1979,180399661,788605300,969004961
China,CHN,1980,189947471,791287550,981235021
China,CHN,1981,199949784,793935200,993884984
China,CHN,1982,210823843,797806140,1008629983
China,CHN,1983,220472140,802837900,1023310040
China,CHN,1984,230206255,806618750,1036825005
China,CHN,1985,240414890,810625100,1051039990
China,CHN,1986,251325056,815464960,1066790016
China,CHN,1987,262976051,821058940,1084034991
China,CHN,1988,275121076,826508900,1101629976
China,CHN,1989,287504237,831145800,1118650037
China,CHN,1990,300165618,835019400,1135185018
China,CHN,1991,314301034,836479000,1150780034
China,CHN,1992,328521540,836448450,1164969990
China,CHN,1993,342961393,835478600,1178439993
China,CHN,1994,357836540,833998460,1191835000
China,CHN,1995,373035157,831819840,1204854997
China,CHN,1996,388593258,828956740,1217549998
China,CHN,1997,404485562,825589440,1230075002
China,CHN,1998,420606126,821328900,1241935026
China,CHN,1999,436766058,815968960,1252735018
China,CHN,2000,452999147,809645800,1262644947
China,CHN,2001,471767321,800082700,1271850021
China,CHN,2002,491993700,788406300,1280400000
China,CHN,2003,512473984,775926000,1288399984
China,CHN,2004,533257098,762817900,1296074998
China,CHN,2005,554367818,749352200,1303720018
China,CHN,2006,575118254,735901760,1311020014
China,CHN,2007,595670841,722214140,1317884981
China,CHN,2008,616481190,708173800,1324654990
China,CHN,2009,637407288,693852740,1331260028
China,CHN,2010,658498663,679206340,1337705003
China,CHN,2011,679390629,665644350,1345034979
China,CHN,2012,700996454,653193540,1354189994
China,CHN,2013,722694421,640545600,1363240021
China,CHN,2014,744357517,627502460,1371859977
China,CHN,2015,765822300,614037700,1379860000
China,CHN,2016,787376534,600413440,1387789974
China,CHN,2017,809246214,586968770,1396214984
China,CHN,2018,829760595,572999400,1402759995
China,CHN,2019,848982855,558762200,1407745055
China,CHN,2020,866810508,544289500,1411100008
China,CHN,2021,882894483,529465500,1412359983
Colombia,COL,1960,7258379,8429309,15687688
Colombia,COL,1961,7719335,8463079,16182414
Colombia,COL,1962,8202597,8488685,16691282
Colombia,COL,1963,8705990,8504966,17210956
Colombia,COL,1964,9229462,8510292,17739754
Colombia,COL,1965,9653285,8622529,18275814
Colombia,COL,1966,10080469,8730938,18811407
Colombia,COL,1967,10513830,8830131,19343961
Colombia,COL,1968,10953127,8919376,19872503
Colombia,COL,1969,11394585,8997679,20392264
Colombia,COL,1970,11839691,9065563,20905254
Colombia,COL,1971,12284567,9120846,21405413
Colombia,COL,1972,12732186,9165869,21898055
Colombia,COL,1973,13189192,9207126,22396318
Colombia,COL,1974,13648734,9249137,22897871
Colombia,COL,1975,14113854,9289877,23403731
Colombia,COL,1976,14587649,9325353,23913002
Colombia,COL,1977,15080191,9363735,24443926
Colombia,COL,1978,15597001,9406607,25003608
Colombia,COL,1979,16130577,9448746,25579323
Colombia,COL,1980,16684183,9492012,26176195
Colombia,COL,1981,17252315,9533667,26785982
Colombia,COL,1982,17833382,9571812,27405194
Colombia,COL,1983,18433064,9609265,28042329
Colombia,COL,1984,19045788,9643244,28689032
Colombia,COL,1985,19658565,9667695,29326260
Colombia,COL,1986,20242842,9717259,29960101
Colombia,COL,1987,20825680,9777368,30603048
Colombia,COL,1988,21420860,9835867,31256727
Colombia,COL,1989,22029505,9893612,31923117
Colombia,COL,1990,22651774,9949619,32601393
Colombia,COL,1991,23273871,9998757,33272628
Colombia,COL,1992,23898174,10040865,33939039
Colombia,COL,1993,24532847,10081888,34614735
Colombia,COL,1994,25175546,10119915,35295461
Colombia,COL,1995,25818259,10151842,35970101
Colombia,COL,1996,26457143,10175430,36632573
Colombia,COL,1997,27097074,10194872,37291946
Colombia,COL,1998,27736608,10207806,37944414
Colombia,COL,1999,28371575,10213458,38585033
Colombia,COL,2000,29002337,10212798,39215135
Colombia,COL,2001,29631013,10206862,39837875
Colombia,COL,2002,30258416,10195634,40454050
Colombia,COL,2003,30879897,10177790,41057687
Colombia,COL,2004,31494420,10153848,41648268
Colombia,COL,2005,32098047,10122893,42220940
Colombia,COL,2006,32688341,10084569,42772910
Colombia,COL,2007,33266384,10040198,43306582
Colombia,COL,2008,33827174,9988139,43815313
Colombia,COL,2009,34381839,9932078,44313917
Colombia,COL,2010,34940430,9875678,44816108
Colombia,COL,2011,35492726,9816173,45308899
Colombia,COL,2012,36031220,9751197,45782417
Colombia,COL,2013,36556170,9681760,46237930
Colombia,COL,2014,37069292,9608655,46677947
Colombia,COL,2015,37584580,9535148,47119728
Colombia,COL,2016,38152200,9473755,47625955
Colombia,COL,2017,38896985,9454686,48351671
Colombia,COL,2018,39804944,9472017,49276961
Colombia,COL,2019,40703994,9483412,50187406
Colombia,COL,2020,41470292,9460370,50930662
Colombia,COL,2021,42109638,9406924,51516562
Comoros,COM,1960,24456,170396,194852
Comoros,COM,1961,26511,172106,198617
Comoros,COM,1962,28737,173790,202527
Comoros,COM,1963,31135,175411,206546
Comoros,COM,1964,33715,176950,210665
Comoros,COM,1965,36492,178447,214939
Comoros,COM,1966,39486,179883,219369
Comoros,COM,1967,41140,183181,224321
Comoros,COM,1968,42970,187001,229971
Comoros,COM,1969,44923,191079,236002
Comoros,COM,1970,46992,195359,242351
Comoros,COM,1971,49191,199875,249066
Comoros,COM,1972,51532,204655,256187
Comoros,COM,1973,54022,209706,263728
Comoros,COM,1974,56678,215041,271719
Comoros,COM,1975,59477,220559,280036
Comoros,COM,1976,62455,226355,288810
Comoros,COM,1977,65635,232517,298152
Comoros,COM,1978,69009,238929,307938
Comoros,COM,1979,72564,245559,318123
Comoros,COM,1980,76221,252107,328328
Comoros,COM,1981,79930,258056,337986
Comoros,COM,1982,83622,263431,347053
Comoros,COM,1983,87425,268712,356137
Comoros,COM,1984,91438,274226,365664
Comoros,COM,1985,95674,279976,375650
Comoros,COM,1986,100138,285930,386068
Comoros,COM,1987,104830,292057,396887
Comoros,COM,1988,109742,298328,408070
Comoros,COM,1989,114874,304710,419584
Comoros,COM,1990,120149,310970,431119
Comoros,COM,1991,125456,316821,442277
Comoros,COM,1992,128808,324182,452990
Comoros,COM,1993,131536,331782,463318
Comoros,COM,1994,134212,339266,473478
Comoros,COM,1995,136909,346851,483760
Comoros,COM,1996,139671,354617,494288
Comoros,COM,1997,142485,362548,505033
Comoros,COM,1998,145335,370624,515959
Comoros,COM,1999,148057,378386,526443
Comoros,COM,2000,150722,386036,536758
Comoros,COM,2001,153565,394176,547741
Comoros,COM,2002,156488,402559,559047
Comoros,COM,2003,159334,410796,570130
Comoros,COM,2004,162159,418995,581154
Comoros,COM,2005,165210,427473,592683
Comoros,COM,2006,168476,436182,604658
Comoros,COM,2007,171911,444988,616899
Comoros,COM,2008,175534,453936,629470
Comoros,COM,2009,179390,463103,642493
Comoros,COM,2010,183510,472514,656024
Comoros,COM,2011,187888,482183,670071
Comoros,COM,2012,192517,492036,684553
Comoros,COM,2013,197390,502003,699393
Comoros,COM,2014,202507,512105,714612
Comoros,COM,2015,207892,522324,730216
Comoros,COM,2016,213564,532668,746232
Comoros,COM,2017,219237,542427,761664
Comoros,COM,2018,224859,551454,776313
Comoros,COM,2019,230683,560303,790986
Comoros,COM,2020,236852,569314,806166
Comoros,COM,2021,243308,578317,821625
Congo,COG,1960,333610,722083,1055693
Congo,COG,1961,350143,733288,1083431
Congo,COG,1962,367575,744773,1112348
Congo,COG,1963,385970,756630,1142600
Congo,COG,1964,405405,768864,1174269
Congo,COG,1965,425890,781522,1207412
Congo,COG,1966,447547,794569,1242116
Congo,COG,1967,470368,807944,1278312
Congo,COG,1968,494457,821673,1316130
Congo,COG,1969,519843,835856,1355699
Congo,COG,1970,546628,850361,1396989
Congo,COG,1971,574897,865262,1440159
Congo,COG,1972,604729,880545,1485274
Congo,COG,1973,636023,896046,1532069
Congo,COG,1974,669359,910921,1580280
Congo,COG,1975,703012,921923,1624935
Congo,COG,1976,735732,929686,1665418
Congo,COG,1977,769334,936847,1706181
Congo,COG,1978,803890,943317,1747207
Congo,COG,1979,839246,948972,1788218
Congo,COG,1980,875427,953829,1829256
Congo,COG,1981,912468,958072,1870540
Congo,COG,1982,950216,961418,1911634
Congo,COG,1983,988281,963570,1951851
Congo,COG,1984,1032097,969642,2001739
Congo,COG,1985,1077087,985468,2062555
Congo,COG,1986,1118570,1006293,2124863
Congo,COG,1987,1161387,1027267,2188654
Congo,COG,1988,1205197,1048139,2253336
Congo,COG,1989,1250152,1069025,2319177
Congo,COG,1990,1295864,1089571,2385435
Congo,COG,1991,1342668,1110007,2452675
Congo,COG,1992,1390611,1130347,2520958
Congo,COG,1993,1441839,1152329,2594168
Congo,COG,1994,1494656,1174564,2669220
Congo,COG,1995,1547019,1195290,2742309
Congo,COG,1996,1600727,1215868,2816595
Congo,COG,1997,1647367,1227670,2875037
Congo,COG,1998,1696683,1240483,2937166
Congo,COG,1999,1756631,1260028,3016659
Congo,COG,2000,1839519,1294511,3134030
Congo,COG,2001,1924996,1329105,3254101
Congo,COG,2002,1985936,1345222,3331158
Congo,COG,2003,2057395,1367258,3424653
Congo,COG,2004,2144691,1398321,3543012
Congo,COG,2005,2239991,1432848,3672839
Congo,COG,2006,2342944,1470379,3813323
Congo,COG,2007,2448691,1507638,3956329
Congo,COG,2008,2549703,1539899,4089602
Congo,COG,2009,2673540,1583690,4257230
Congo,COG,2010,2807228,1630656,4437884
Congo,COG,2011,2920696,1663520,4584216
Congo,COG,2012,3024450,1688807,4713257
Congo,COG,2013,3120234,1707832,4828066
Congo,COG,2014,3218363,1726498,4944861
Congo,COG,2015,3319351,1745035,5064386
Congo,COG,2016,3423356,1763468,5186824
Congo,COG,2017,3530528,1781812,5312340
Congo,COG,2018,3640941,1800121,5441062
Congo,COG,2019,3753170,1817563,5570733
Congo,COG,2020,3867728,1834446,5702174
Congo,COG,2021,3984863,1850943,5835806
Costa Rica,CRI,1960,461162,885140,1346302
Costa Rica,CRI,1961,479280,916858,1396138
Costa Rica,CRI,1962,497839,949198,1447037
Costa Rica,CRI,1963,518622,980025,1498647
Costa Rica,CRI,1964,545786,1004875,1550661
Costa Rica,CRI,1965,573635,1029101,1602736
Costa Rica,CRI,1966,602116,1052503,1654619
Costa Rica,CRI,1967,631124,1074938,1706062
Costa Rica,CRI,1968,660399,1095934,1756333
Costa Rica,CRI,1969,690096,1115872,1805968
Costa Rica,CRI,1970,720511,1135186,1855697
Costa Rica,CRI,1971,751619,1153867,1905486
Costa Rica,CRI,1972,783549,1171998,1955547
Costa Rica,CRI,1973,815640,1190607,2006247
Costa Rica,CRI,1974,843918,1214317,2058235
Costa Rica,CRI,1975,873229,1238621,2111850
Costa Rica,CRI,1976,903822,1263722,2167544
Costa Rica,CRI,1977,935788,1289842,2225630
Costa Rica,CRI,1978,969262,1316948,2286210
Costa Rica,CRI,1979,1004237,1345021,2349258
Costa Rica,CRI,1980,1040540,1373763,2414303
Costa Rica,CRI,1981,1078140,1403194,2481334
Costa Rica,CRI,1982,1117318,1433462,2550780
Costa Rica,CRI,1983,1158005,1464527,2622532
Costa Rica,CRI,1984,1200941,1495259,2696200
Costa Rica,CRI,1985,1259491,1511972,2771463
Costa Rica,CRI,1986,1320063,1527786,2847849
Costa Rica,CRI,1987,1382281,1542314,2924595
Costa Rica,CRI,1988,1446014,1555447,3001461
Costa Rica,CRI,1989,1511451,1567550,3079001
Costa Rica,CRI,1990,1579221,1579032,3158253
Costa Rica,CRI,1991,1649412,1590002,3239414
Costa Rica,CRI,1992,1721827,1600112,3321939
Costa Rica,CRI,1993,1796095,1609277,3405372
Costa Rica,CRI,1994,1872035,1617117,3489152
Costa Rica,CRI,1995,1949386,1623470,3572856
Costa Rica,CRI,1996,2028003,1628231,3656234
Costa Rica,CRI,1997,2107799,1631622,3739421
Costa Rica,CRI,1998,2188299,1633122,3821421
Costa Rica,CRI,1999,2268955,1632475,3901430
Costa Rica,CRI,2000,2349793,1629400,3979193
Costa Rica,CRI,2001,2448551,1604671,4053222
Costa Rica,CRI,2002,2545843,1576780,4122623
Costa Rica,CRI,2003,2642175,1546435,4188610
Costa Rica,CRI,2004,2738293,1514507,4252800
Costa Rica,CRI,2005,2834329,1481558,4315887
Costa Rica,CRI,2006,2930529,1447643,4378172
Costa Rica,CRI,2007,3026939,1413080,4440019
Costa Rica,CRI,2008,3123883,1378038,4501921
Costa Rica,CRI,2009,3220427,1342700,4563127
Costa Rica,CRI,2010,3315819,1306433,4622252
Costa Rica,CRI,2011,3410168,1269758,4679926
Costa Rica,CRI,2012,3502521,1234072,4736593
Costa Rica,CRI,2013,3592214,1199321,4791535
Costa Rica,CRI,2014,3678801,1165487,4844288
Costa Rica,CRI,2015,3762581,1132661,4895242
Costa Rica,CRI,2016,3844155,1101050,4945205
Costa Rica,CRI,2017,3923162,1070680,4993842
Costa Rica,CRI,2018,3999318,1041416,5040734
Costa Rica,CRI,2019,4071490,1013042,5084532
Costa Rica,CRI,2020,4137983,985122,5123105
Costa Rica,CRI,2021,4196609,957348,5153957
Cote d'Ivoire,CIV,1960,655654,3053007,3708661
Cote d'Ivoire,CIV,1961,727759,3120577,3848336
Cote d'Ivoire,CIV,1962,808054,3190233,3998287
Cote d'Ivoire,CIV,1963,896755,3259698,4156453
Cote d'Ivoire,CIV,1964,994217,3327151,4321368
Cote d'Ivoire,CIV,1965,1100758,3392132,4492890
Cote d'Ivoire,CIV,1966,1177422,3493774,4671196
Cote d'Ivoire,CIV,1967,1259145,3597544,4856689
Cote d'Ivoire,CIV,1968,1346308,3703798,5050106
Cote d'Ivoire,CIV,1969,1440121,3815028,5255149
Cote d'Ivoire,CIV,1970,1542512,3934574,5477086
Cote d'Ivoire,CIV,1971,1654697,4064170,5718867
Cote d'Ivoire,CIV,1972,1777191,4202793,5979984
Cote d'Ivoire,CIV,1973,1909312,4348061,6257373
Cote d'Ivoire,CIV,1974,2051188,4497735,6548923
Cote d'Ivoire,CIV,1975,2208970,4645011,6853981
Cote d'Ivoire,CIV,1976,2399515,4743175,7142690
Cote d'Ivoire,CIV,1977,2594304,4821596,7415900
Cote d'Ivoire,CIV,1978,2803097,4897719,7700816
Cote d'Ivoire,CIV,1979,2927790,5068578,7996368
Cote d'Ivoire,CIV,1980,3058210,5245600,8303810
Cote d'Ivoire,CIV,1981,3193793,5427828,8621621
Cote d'Ivoire,CIV,1982,3334069,5614050,8948119
Cote d'Ivoire,CIV,1983,3478541,5803509,9282050
Cote d'Ivoire,CIV,1984,3626596,5994809,9621405
Cote d'Ivoire,CIV,1985,3777381,6186694,9964075
Cote d'Ivoire,CIV,1986,3930680,6378760,10309440
Cote d'Ivoire,CIV,1987,4089025,6574473,10663498
Cote d'Ivoire,CIV,1988,4263556,6779637,11043193
Cote d'Ivoire,CIV,1989,4467797,6995146,11462943
Cote d'Ivoire,CIV,1990,4686202,7224338,11910540
Cote d'Ivoire,CIV,1991,4912579,7456690,12369269
Cote d'Ivoire,CIV,1992,5146623,7691691,12838314
Cote d'Ivoire,CIV,1993,5387968,7928480,13316448
Cote d'Ivoire,CIV,1994,5636163,8166122,13802285
Cote d'Ivoire,CIV,1995,5892917,8406810,14299727
Cote d'Ivoire,CIV,1996,6159428,8651518,14810946
Cote d'Ivoire,CIV,1997,6435369,8900084,15335453
Cote d'Ivoire,CIV,1998,6715014,9143976,15858990
Cote d'Ivoire,CIV,1999,6986399,9359495,16345894
Cote d'Ivoire,CIV,2000,7249898,9549772,16799670
Cote d'Ivoire,CIV,2001,7513505,9731963,17245468
Cote d'Ivoire,CIV,2002,7777908,9905989,17683897
Cote d'Ivoire,CIV,2003,8043523,10072928,18116451
Cote d'Ivoire,CIV,2004,8311269,10233634,18544903
Cote d'Ivoire,CIV,2005,8580987,10389228,18970215
Cote d'Ivoire,CIV,2006,8853775,10540282,19394057
Cote d'Ivoire,CIV,2007,9130213,10687487,19817700
Cote d'Ivoire,CIV,2008,9411847,10832602,20244449
Cote d'Ivoire,CIV,2009,9699938,10977824,20677762
Cote d'Ivoire,CIV,2010,9996116,11123926,21120042
Cote d'Ivoire,CIV,2011,10296507,11266407,21562914
Cote d'Ivoire,CIV,2012,10603000,11407712,22010712
Cote d'Ivoire,CIV,2013,10918491,11550777,22469268
Cote d'Ivoire,CIV,2014,11271041,11724514,22995555
Cote d'Ivoire,CIV,2015,11667173,11929568,23596741
Cote d'Ivoire,CIV,2016,12077997,12135625,24213622
Cote d'Ivoire,CIV,2017,12505013,12343003,24848016
Cote d'Ivoire,CIV,2018,12945592,12548396,25493988
Cote d'Ivoire,CIV,2019,13397744,12749807,26147551
Cote d'Ivoire,CIV,2020,13863304,12948486,26811790
Cote d'Ivoire,CIV,2021,14338150,13140099,27478249
Croatia,HRV,1960,1248430,2891751,4140181
Croatia,HRV,1961,1293527,2873765,4167292
Croatia,HRV,1962,1342990,2853722,4196712
Croatia,HRV,1963,1393585,2832090,4225675
Croatia,HRV,1964,1444787,2808089,4252876
Croatia,HRV,1965,1497338,2783585,4280923
Croatia,HRV,1966,1551723,2758978,4310701
Croatia,HRV,1967,1606614,2732069,4338683
Croatia,HRV,1968,1662257,2703371,4365628
Croatia,HRV,1969,1718390,2673100,4391490
Croatia,HRV,1970,1773549,2638703,4412252
Croatia,HRV,1971,1824267,2607008,4431275
Croatia,HRV,1972,1862071,2588493,4450564
Croatia,HRV,1973,1900310,2569851,4470161
Croatia,HRV,1974,1939336,2551324,4490660
Croatia,HRV,1975,1979180,2532902,4512082
Croatia,HRV,1976,2020532,2515402,4535934
Croatia,HRV,1977,2062157,2497414,4559571
Croatia,HRV,1978,2103222,2477863,4581085
Croatia,HRV,1979,2141029,2453749,4594778
Croatia,HRV,1980,2175007,2424775,4599782
Croatia,HRV,1981,2208313,2403196,4611509
Croatia,HRV,1982,2235415,2398819,4634234
Croatia,HRV,1983,2263306,2394948,4658254
Croatia,HRV,1984,2290391,2389894,4680285
Croatia,HRV,1985,2317187,2384230,4701417
Croatia,HRV,1986,2343584,2377862,4721446
Croatia,HRV,1987,2369256,2370489,4739745
Croatia,HRV,1988,2393676,2361531,4755207
Croatia,HRV,1989,2416381,2350879,4767260
Croatia,HRV,1990,2438225,2339143,4777368
Croatia,HRV,1991,2408141,2280881,4689022
Croatia,HRV,1992,2360573,2215245,4575818
Croatia,HRV,1993,2383868,2216595,4600463
Croatia,HRV,1994,2421285,2230739,4652024
Croatia,HRV,1995,2415305,2204725,4620030
Croatia,HRV,1996,2392886,2164211,4557097
Croatia,HRV,1997,2391671,2143249,4534920
Croatia,HRV,1998,2400581,2131554,4532135
Croatia,HRV,1999,2400611,2111986,4512597
Croatia,HRV,2000,2387324,2080978,4468302
Croatia,HRV,2001,2306414,1993228,4299642
Croatia,HRV,2002,2315000,1987174,4302174
Croatia,HRV,2003,2322932,1980467,4303399
Croatia,HRV,2004,2330812,1973788,4304600
Croatia,HRV,2005,2341055,1969090,4310145
Croatia,HRV,2006,2348849,1962310,4311159
Croatia,HRV,2007,2355577,1954640,4310217
Croatia,HRV,2008,2362537,1947168,4309705
Croatia,HRV,2009,2367290,1937891,4305181
Croatia,HRV,2010,2369143,1926284,4295427
Croatia,HRV,2011,2368126,1912496,4280622
Croatia,HRV,2012,2368751,1898807,4267558
Croatia,HRV,2013,2370674,1885015,4255689
Croatia,HRV,2014,2370234,1868155,4238389
Croatia,HRV,2015,2360534,1843070,4203604
Croatia,HRV,2016,2354458,1819891,4174349
Croatia,HRV,2017,2337248,1787283,4124531
Croatia,HRV,2018,2327904,1759939,4087843
Croatia,HRV,2019,2327032,1738221,4065253
Croatia,HRV,2020,2329561,1718119,4047680
Croatia,HRV,2021,2256663,1642337,3899000
Cuba,CUB,1960,4244231,3023164,7267395
Cuba,CUB,1961,4346361,3072157,7418518
Cuba,CUB,1962,4451850,3122415,7574265
Cuba,CUB,1963,4561585,3174767,7736352
Cuba,CUB,1964,4674202,3228084,7902286
Cuba,CUB,1965,4787102,3280549,8067651
Cuba,CUB,1966,4899011,3331439,8230450
Cuba,CUB,1967,5010160,3380802,8390962
Cuba,CUB,1968,5121194,3429092,8550286
Cuba,CUB,1969,5232847,3476807,8709654
Cuba,CUB,1970,5345375,3524261,8869636
Cuba,CUB,1971,5503516,3522193,9025709
Cuba,CUB,1972,5666621,3502668,9169289
Cuba,CUB,1973,5821802,3476122,9297924
Cuba,CUB,1974,5970074,3443031,9413105
Cuba,CUB,1975,6110467,3403838,9514305
Cuba,CUB,1976,6242288,3358574,9600862
Cuba,CUB,1977,6364729,3307817,9672546
Cuba,CUB,1978,6478127,3251859,9729986
Cuba,CUB,1979,6582877,3191834,9774711
Cuba,CUB,1980,6680590,3128517,9809107
Cuba,CUB,1981,6781029,3067531,9848560
Cuba,CUB,1982,6878146,3030728,9908874
Cuba,CUB,1983,6981725,3002866,9984591
Cuba,CUB,1984,7089461,2976078,10065539
Cuba,CUB,1985,7199021,2950023,10149044
Cuba,CUB,1986,7311203,2924277,10235480
Cuba,CUB,1987,7427217,2899693,10326910
Cuba,CUB,1988,7548848,2876585,10425433
Cuba,CUB,1989,7673056,2854131,10527187
Cuba,CUB,1990,7796158,2830522,10626680
Cuba,CUB,1991,7893508,2820304,10713812
Cuba,CUB,1992,7961318,2822430,10783748
Cuba,CUB,1993,8019798,2821136,10840934
Cuba,CUB,1994,8070360,2816847,10887207
Cuba,CUB,1995,8116027,2810676,10926703
Cuba,CUB,1996,8159345,2803686,10963031
Cuba,CUB,1997,8206584,2791545,10998129
Cuba,CUB,1998,8259320,2774438,11033758
Cuba,CUB,1999,8312423,2757671,11070094
Cuba,CUB,2000,8365215,2740576,11105791
Cuba,CUB,2001,8416167,2722960,11139127
Cuba,CUB,2002,8465223,2704828,11170051
Cuba,CUB,2003,8505469,2693748,11199217
Cuba,CUB,2004,8535826,2689468,11225294
Cuba,CUB,2005,8562116,2683998,11246114
Cuba,CUB,2006,8583640,2676990,11260630
Cuba,CUB,2007,8601178,2668709,11269887
Cuba,CUB,2008,8616795,2659814,11276609
Cuba,CUB,2009,8632201,2650984,11283185
Cuba,CUB,2010,8648121,2642296,11290417
Cuba,CUB,2011,8664868,2633842,11298710
Cuba,CUB,2012,8683386,2625904,11309290
Cuba,CUB,2013,8698029,2623550,11321579
Cuba,CUB,2014,8709909,2622117,11332026
Cuba,CUB,2015,8719925,2619969,11339894
Cuba,CUB,2016,8725410,2616602,11342012
Cuba,CUB,2017,8726424,2609981,11336405
Cuba,CUB,2018,8726939,2601305,11328244
Cuba,CUB,2019,8726192,2590505,11316697
Cuba,CUB,2020,8723461,2577237,11300698
Cuba,CUB,2021,8700275,2556097,11256372
Curacao,CUW,1960,93258,31568,124826
Curacao,CUW,1961,94722,31403,126125
Curacao,CUW,1962,96940,31474,128414
Curacao,CUW,1963,99290,31570,130860
Curacao,CUW,1964,101532,31616,133148
Curacao,CUW,1965,103656,31610,135266
Curacao,CUW,1966,105249,31433,136682
Curacao,CUW,1967,106879,31261,138140
Curacao,CUW,1968,109059,31239,140298
Curacao,CUW,1969,111346,31235,142581
Curacao,CUW,1970,113545,31194,144739
Curacao,CUW,1971,116141,31248,147389
Curacao,CUW,1972,116907,30803,147710
Curacao,CUW,1973,116777,30135,146912
Curacao,CUW,1974,118424,29927,148351
Curacao,CUW,1975,119543,29586,149129
Curacao,CUW,1976,120253,29146,149399
Curacao,CUW,1977,120788,28671,149459
Curacao,CUW,1978,120361,27980,148341
Curacao,CUW,1979,120434,27417,147851
Curacao,CUW,1980,121052,26989,148041
Curacao,CUW,1981,121992,26637,148629
Curacao,CUW,1982,123658,26443,150101
Curacao,CUW,1983,124984,26175,151159
Curacao,CUW,1984,126083,25857,151940
Curacao,CUW,1985,127169,25542,152711
Curacao,CUW,1986,127569,25093,152662
Curacao,CUW,1987,126993,24463,151456
Curacao,CUW,1988,125566,23688,149254
Curacao,CUW,1989,124022,22915,146937
Curacao,CUW,1990,123122,22278,145400
Curacao,CUW,1991,122666,21737,144403
Curacao,CUW,1992,122964,20948,143912
Curacao,CUW,1993,124420,19879,144299
Curacao,CUW,1994,125783,18847,144630
Curacao,CUW,1995,127258,17881,145139
Curacao,CUW,1996,129273,17033,146306
Curacao,CUW,1997,130794,16162,146956
Curacao,CUW,1998,129469,15003,144472
Curacao,CUW,1999,125761,13667,139428
Curacao,CUW,2000,121481,12379,133860
Curacao,CUW,2001,117447,11600,129047
Curacao,CUW,2002,117440,11765,129205
Curacao,CUW,2003,119730,12167,131897
Curacao,CUW,2004,121652,12540,134192
Curacao,CUW,2005,124627,13031,137658
Curacao,CUW,2006,127696,13543,141239
Curacao,CUW,2007,130064,13992,144056
Curacao,CUW,2008,131527,14353,145880
Curacao,CUW,2009,132200,14633,146833
Curacao,CUW,2010,133691,15012,148703
Curacao,CUW,2011,135409,15422,150831
Curacao,CUW,2012,136353,15735,152088
Curacao,CUW,2013,137738,16084,153822
Curacao,CUW,2014,139450,16459,155909
Curacao,CUW,2015,141158,16822,157980
Curacao,CUW,2016,142535,17129,159664
Curacao,CUW,2017,142881,17294,160175
Curacao,CUW,2018,142040,17296,159336
Curacao,CUW,2019,140277,17164,157441
Curacao,CUW,2020,137999,16948,154947
Curacao,CUW,2021,135666,16703,152369
Cyprus,CYP,1960,208682,377043,585725
Cyprus,CYP,1961,215158,379613,594771
Cyprus,CYP,1962,220446,380649,601095
Cyprus,CYP,1963,225685,381387,607072
Cyprus,CYP,1964,230735,381603,612338
Cyprus,CYP,1965,235752,381593,617345
Cyprus,CYP,1966,240921,381645,622566
Cyprus,CYP,1967,246119,381576,627695
Cyprus,CYP,1968,251248,381204,632452
Cyprus,CYP,1969,256270,380551,636821
Cyprus,CYP,1970,261198,379606,640804
Cyprus,CYP,1971,266033,378380,644413
Cyprus,CYP,1972,270750,376870,647620
Cyprus,CYP,1973,278222,372483,650705
Cyprus,CYP,1974,291909,356676,648585
Cyprus,CYP,1975,304928,340054,644982
Cyprus,CYP,1976,321598,327270,648868
Cyprus,CYP,1977,340305,316109,656414
Cyprus,CYP,1978,359337,304638,663975
Cyprus,CYP,1979,378641,292970,671611
Cyprus,CYP,1980,398181,281146,679327
Cyprus,CYP,1981,417861,269309,687170
Cyprus,CYP,1982,438372,257855,696227
Cyprus,CYP,1983,451526,255951,707477
Cyprus,CYP,1984,462408,257270,719678
Cyprus,CYP,1985,473226,258438,731664
Cyprus,CYP,1986,483998,259448,743446
Cyprus,CYP,1987,494720,260301,755021
Cyprus,CYP,1988,505410,261002,766412
Cyprus,CYP,1989,516018,261574,777592
Cyprus,CYP,1990,526529,261971,788500
Cyprus,CYP,1991,536873,262188,799061
Cyprus,CYP,1992,547835,262596,810431
Cyprus,CYP,1993,559952,266034,825986
Cyprus,CYP,1994,573504,270940,844444
Cyprus,CYP,1995,586772,275646,862418
Cyprus,CYP,1996,599856,280202,880058
Cyprus,CYP,1997,612820,284651,897471
Cyprus,CYP,1998,625673,288987,914660
Cyprus,CYP,1999,638398,293202,931600
Cyprus,CYP,2000,650946,297291,948237
Cyprus,CYP,2001,663504,301326,964830
Cyprus,CYP,2002,674708,307486,982194
Cyprus,CYP,2003,685770,314580,1000350
Cyprus,CYP,2004,696882,321802,1018684
Cyprus,CYP,2005,707981,329081,1037062
Cyprus,CYP,2006,719017,336421,1055438
Cyprus,CYP,2007,730040,343833,1073873
Cyprus,CYP,2008,741066,351324,1092390
Cyprus,CYP,2009,752074,358900,1110974
Cyprus,CYP,2010,763114,366572,1129686
Cyprus,CYP,2011,771857,373229,1145086
Cyprus,CYP,2012,777911,378645,1156556
Cyprus,CYP,2013,783467,383501,1166968
Cyprus,CYP,2014,788952,388043,1176995
Cyprus,CYP,2015,794836,392444,1187280
Cyprus,CYP,2016,801155,396726,1197881
Cyprus,CYP,2017,807728,400795,1208523
Cyprus,CYP,2018,814301,404530,1218831
Cyprus,CYP,2019,820924,407912,1228836
Cyprus,CYP,2020,826935,410602,1237537
Cyprus,CYP,2021,831814,412374,1244188
Czechia,CZE,1960,5717803,3884203,9602006
Czechia,CZE,1961,5758030,3828621,9586651
Czechia,CZE,1962,5828213,3796447,9624660
Czechia,CZE,1963,5903373,3767312,9670685
Czechia,CZE,1964,5985712,3742092,9727804
Czechia,CZE,1965,6064767,3714591,9779358
Czechia,CZE,1966,6137954,3683086,9821040
Czechia,CZE,1967,6205159,3647740,9852899
Czechia,CZE,1968,6267134,3609212,9876346
Czechia,CZE,1969,6326884,3569696,9896580
Czechia,CZE,1970,6348795,3509276,9858071
Czechia,CZE,1971,6416419,3410396,9826815
Czechia,CZE,1972,6560396,3307236,9867632
Czechia,CZE,1973,6712314,3209952,9922266
Czechia,CZE,1974,6871460,3116999,9988459
Czechia,CZE,1975,7032685,3025935,10058620
Czechia,CZE,1976,7191239,2934700,10125939
Czechia,CZE,1977,7343835,2842920,10186755
Czechia,CZE,1978,7491275,2750823,10242098
Czechia,CZE,1979,7633521,2658820,10292341
Czechia,CZE,1980,7745353,2558840,10304193
Czechia,CZE,1981,7774989,2525602,10300591
Czechia,CZE,1982,7782743,2532083,10314826
Czechia,CZE,1983,7786562,2537294,10323856
Czechia,CZE,1984,7788361,2541852,10330213
Czechia,CZE,1985,7790569,2546549,10337118
Czechia,CZE,1986,7791420,2550807,10342227
Czechia,CZE,1987,7792255,2555063,10347318
Czechia,CZE,1988,7795245,2560031,10355276
Czechia,CZE,1989,7796600,2564468,10361068
Czechia,CZE,1990,7772750,2560605,10333355
Czechia,CZE,1991,7747721,2560857,10308578
Czechia,CZE,1992,7742438,2576685,10319123
Czechia,CZE,1993,7737165,2592690,10329855
Czechia,CZE,1994,7726630,2606957,10333587
Czechia,CZE,1995,7708571,2618682,10327253
Czechia,CZE,1996,7686196,2629045,10315241
Czechia,CZE,1997,7664419,2639712,10304131
Czechia,CZE,1998,7643675,2650698,10294373
Czechia,CZE,1999,7622397,2661463,10283860
Czechia,CZE,2000,7587516,2667547,10255063
Czechia,CZE,2001,7547721,2668884,10216605
Czechia,CZE,2002,7526242,2670674,10196916
Czechia,CZE,2003,7517054,2676944,10193998
Czechia,CZE,2004,7512306,2684795,10197101
Czechia,CZE,2005,7515659,2695557,10211216
Czechia,CZE,2006,7528974,2709931,10238905
Czechia,CZE,2007,7565828,2733000,10298828
Czechia,CZE,2008,7621676,2762927,10384603
Czechia,CZE,2009,7657912,2786024,10443936
Czechia,CZE,2010,7673029,2801381,10474410
Czechia,CZE,2011,7681562,2814526,10496088
Czechia,CZE,2012,7693579,2817206,10510785
Czechia,CZE,2013,7705910,2808362,10514272
Czechia,CZE,2014,7723921,2801426,10525347
Czechia,CZE,2015,7748928,2797131,10546059
Czechia,CZE,2016,7773650,2792682,10566332
Czechia,CZE,2017,7805452,2788986,10594438
Czechia,CZE,2018,7844036,2785892,10629928
Czechia,CZE,2019,7888753,2783117,10671870
Czechia,CZE,2020,7922941,2774917,10697858
Czechia,CZE,2021,7796754,2709018,10505772
Democratic Republic of Congo,COD,1960,3406672,11869886,15276558
Democratic Republic of Congo,COD,1961,3530094,12143190,15673284
Democratic Republic of Congo,COD,1962,3659423,12426661,16086084
Democratic Republic of Congo,COD,1963,3795175,12722820,16517995
Democratic Republic of Congo,COD,1964,3936757,13029098,16965855
Democratic Republic of Congo,COD,1965,4086480,13351774,17438254
Democratic Republic of Congo,COD,1966,4246092,13695646,17941738
Democratic Republic of Congo,COD,1967,4414648,14057457,18472105
Democratic Republic of Congo,COD,1968,4590962,14431837,19022799
Democratic Republic of Congo,COD,1969,4772407,14810716,19583123
Democratic Republic of Congo,COD,1970,4958938,15192795,20151733
Democratic Republic of Congo,COD,1971,5146547,15566405,20712952
Democratic Republic of Congo,COD,1972,5337286,15936123,21273409
Democratic Republic of Congo,COD,1973,5535813,16318093,21853906
Democratic Republic of Congo,COD,1974,5741182,16707233,22448415
Democratic Republic of Congo,COD,1975,5952442,17100272,23052714
Democratic Republic of Congo,COD,1976,6166390,17488626,23655016
Democratic Republic of Congo,COD,1977,6383574,17872890,24256464
Democratic Republic of Congo,COD,1978,6645800,18369444,25015244
Democratic Republic of Congo,COD,1979,6946861,18955900,25902761
Democratic Republic of Congo,COD,1980,7230575,19478112,26708687
Democratic Republic of Congo,COD,1981,7503388,19954396,27457784
Democratic Republic of Congo,COD,1982,7783707,20435512,28219219
Democratic Republic of Congo,COD,1983,8075041,20930134,29005175
Democratic Republic of Congo,COD,1984,8396238,21483614,29879852
Democratic Republic of Congo,COD,1985,8782019,22018032,30800051
Democratic Republic of Congo,COD,1986,9178081,22547052,31725133
Democratic Republic of Congo,COD,1987,9601140,23111434,32712574
Democratic Republic of Congo,COD,1988,10049078,23700974,33750052
Democratic Republic of Congo,COD,1989,10518116,24307776,34825892
Democratic Republic of Congo,COD,1990,11024063,24963478,35987541
Democratic Republic of Congo,COD,1991,11555312,25639500,37194812
Democratic Republic of Congo,COD,1992,12076975,26255328,38332303
Democratic Republic of Congo,COD,1993,12644496,26936348,39580844
Democratic Republic of Congo,COD,1994,13445732,28066252,41511984
Democratic Republic of Congo,COD,1995,14214188,29071604,43285792
Democratic Republic of Congo,COD,1996,14686677,29432032,44118709
Democratic Republic of Congo,COD,1997,15123906,29698292,44822198
Democratic Republic of Congo,COD,1998,15695810,30199714,45895524
Democratic Republic of Congo,COD,1999,16368488,30858750,47227238
Democratic Republic of Congo,COD,2000,17075023,31541294,48616317
Democratic Republic of Congo,COD,2001,17831456,32275200,50106656
Democratic Republic of Congo,COD,2002,18626760,33035312,51662072
Democratic Republic of Congo,COD,2003,19433892,33771748,53205640
Democratic Republic of Congo,COD,2004,20281775,34533830,54815605
Democratic Republic of Congo,COD,2005,21195598,35354650,56550248
Democratic Republic of Congo,COD,2006,22168089,36213540,58381629
Democratic Republic of Congo,COD,2007,23193341,37096080,60289421
Democratic Republic of Congo,COD,2008,24262452,37987270,62249722
Democratic Republic of Congo,COD,2009,25380957,38889276,64270233
Democratic Republic of Congo,COD,2010,26565134,39826124,66391258
Democratic Republic of Congo,COD,2011,27835187,40819080,68654267
Democratic Republic of Congo,COD,2012,29167345,41830524,70997869
Democratic Republic of Congo,COD,2013,30579203,42880816,73460019
Democratic Republic of Congo,COD,2014,32071811,43963776,76035587
Democratic Republic of Congo,COD,2015,33617961,45038944,78656905
Democratic Republic of Congo,COD,2016,35265313,46165664,81430977
Democratic Republic of Congo,COD,2017,36983500,47299772,84283272
Democratic Republic of Congo,COD,2018,38719038,48368316,87087354
Democratic Republic of Congo,COD,2019,40499458,49407430,89906888
Democratic Republic of Congo,COD,2020,42376327,50476836,92853163
Democratic Republic of Congo,COD,2021,44336645,51557470,95894115
Denmark,DNK,1960,3374572,1205031,4579603
Denmark,DNK,1961,3431879,1179808,4611687
Denmark,DNK,1962,3490118,1157609,4647727
Denmark,DNK,1963,3548824,1135659,4684483
Denmark,DNK,1964,3608088,1113984,4722072
Denmark,DNK,1965,3666724,1092288,4759012
Denmark,DNK,1966,3723679,1073702,4797381
Denmark,DNK,1967,3779458,1055896,4835354
Denmark,DNK,1968,3828566,1036317,4864883
Denmark,DNK,1969,3875429,1016431,4891860
Denmark,DNK,1970,3930043,998714,4928757
Denmark,DNK,1971,3982363,980763,4963126
Denmark,DNK,1972,4029765,961831,4991596
Denmark,DNK,1973,4078304,943557,5021861
Denmark,DNK,1974,4121150,924147,5045297
Denmark,DNK,1975,4156474,903388,5059862
Denmark,DNK,1976,4189964,882632,5072596
Denmark,DNK,1977,4217587,870832,5088419
Denmark,DNK,1978,4245152,859096,5104248
Denmark,DNK,1979,4269868,846933,5116801
Denmark,DNK,1980,4289152,833875,5123027
Denmark,DNK,1981,4297767,823805,5121572
Denmark,DNK,1982,4300240,817570,5117810
Denmark,DNK,1983,4302863,811434,5114297
Denmark,DNK,1984,4306181,805438,5111619
Denmark,DNK,1985,4313449,800242,5113691
Denmark,DNK,1986,4324701,795833,5120534
Denmark,DNK,1987,4335668,791356,5127024
Denmark,DNK,1988,4343212,786304,5129516
Denmark,DNK,1989,4351259,781335,5132594
Denmark,DNK,1990,4361727,779212,5140939
Denmark,DNK,1991,4374504,779794,5154298
Denmark,DNK,1992,4390390,780980,5171370
Denmark,DNK,1993,4406442,782186,5188628
Denmark,DNK,1994,4422754,783426,5206180
Denmark,DNK,1995,4447268,786105,5233373
Denmark,DNK,1996,4473929,789145,5263074
Denmark,DNK,1997,4493986,791005,5284991
Denmark,DNK,1998,4511769,792450,5304219
Denmark,DNK,1999,4528106,793693,5321799
Denmark,DNK,2000,4544013,795603,5339616
Denmark,DNK,2001,4563004,795779,5358783
Denmark,DNK,2002,4582981,792950,5375931
Denmark,DNK,2003,4601394,789180,5390574
Denmark,DNK,2004,4624434,780089,5404523
Denmark,DNK,2005,4652908,766524,5419432
Denmark,DNK,2006,4681382,755890,5437272
Denmark,DNK,2007,4712839,748599,5461438
Denmark,DNK,2008,4751268,742353,5493621
Denmark,DNK,2009,4785983,737112,5523095
Denmark,DNK,2010,4815111,732572,5547683
Denmark,DNK,2011,4844002,726570,5570572
Denmark,DNK,2012,4872608,718964,5591572
Denmark,DNK,2013,4901386,713546,5614932
Denmark,DNK,2014,4932961,710514,5643475
Denmark,DNK,2015,4974525,708958,5683483
Denmark,DNK,2016,5020143,707867,5728010
Denmark,DNK,2017,5059173,705807,5764980
Denmark,DNK,2018,5091100,702536,5793636
Denmark,DNK,2019,5116342,698080,5814422
Denmark,DNK,2020,5138400,693004,5831404
Denmark,DNK,2021,5167981,688752,5856733
Djibouti,DJI,1960,43249,42691,85940
Djibouti,DJI,1961,45928,43342,89270
Djibouti,DJI,1962,49000,44122,93122
Djibouti,DJI,1963,52534,45136,97670
Djibouti,DJI,1964,56570,46375,102945
Djibouti,DJI,1965,61031,47741,108772
Djibouti,DJI,1966,65777,49097,114874
Djibouti,DJI,1967,70767,50401,121168
Djibouti,DJI,1968,76014,51654,127668
Djibouti,DJI,1969,82133,53257,135390
Djibouti,DJI,1970,89193,55186,144379
Djibouti,DJI,1971,96974,57251,154225
Djibouti,DJI,1972,105697,59537,165234
Djibouti,DJI,1973,115333,61994,177327
Djibouti,DJI,1974,126506,64883,191389
Djibouti,DJI,1975,140046,68536,208582
Djibouti,DJI,1976,156317,72987,229304
Djibouti,DJI,1977,175078,78005,253083
Djibouti,DJI,1978,195368,83057,278425
Djibouti,DJI,1979,215455,87401,302856
Djibouti,DJI,1980,233678,90443,324121
Djibouti,DJI,1981,249256,92060,341316
Djibouti,DJI,1982,262575,92535,355110
Djibouti,DJI,1983,273971,93755,367726
Djibouti,DJI,1984,285528,96628,382156
Djibouti,DJI,1985,300231,100478,400709
Djibouti,DJI,1986,318783,105503,424286
Djibouti,DJI,1987,340746,111526,452272
Djibouti,DJI,1988,364396,117941,482337
Djibouti,DJI,1989,394752,126352,521104
Djibouti,DJI,1990,438403,138770,577173
Djibouti,DJI,1991,478392,150129,628521
Djibouti,DJI,1992,474633,148564,623197
Djibouti,DJI,1993,465801,145430,611231
Djibouti,DJI,1994,475426,148051,623477
Djibouti,DJI,1995,480399,149220,629619
Djibouti,DJI,1996,492170,152479,644649
Djibouti,DJI,1997,510142,157644,667786
Djibouti,DJI,1998,531190,163730,694920
Djibouti,DJI,1999,550211,169160,719371
Djibouti,DJI,2000,567893,174140,742033
Djibouti,DJI,2001,586197,179293,765490
Djibouti,DJI,2002,604662,184467,789129
Djibouti,DJI,2003,618275,188136,806411
Djibouti,DJI,2004,627823,190550,818373
Djibouti,DJI,2005,637777,193084,830861
Djibouti,DJI,2006,650515,196432,846947
Djibouti,DJI,2007,664929,200267,865196
Djibouti,DJI,2008,678931,203955,882886
Djibouti,DJI,2009,693345,207758,901103
Djibouti,DJI,2010,707774,211425,919199
Djibouti,DJI,2011,721944,214867,936811
Djibouti,DJI,2012,736126,218171,954297
Djibouti,DJI,2013,750407,221346,971753
Djibouti,DJI,2014,764703,224384,989087
Djibouti,DJI,2015,779016,227243,1006259
Djibouti,DJI,2016,793314,229947,1023261
Djibouti,DJI,2017,807720,232513,1040233
Djibouti,DJI,2018,822257,234941,1057198
Djibouti,DJI,2019,836802,237192,1073994
Djibouti,DJI,2020,850998,239158,1090156
Djibouti,DJI,2021,864734,240823,1105557
Dominica,DMA,1960,22473,36906,59379
Dominica,DMA,1961,22897,37498,60395
Dominica,DMA,1962,23252,37972,61224
Dominica,DMA,1963,23600,38431,62031
Dominica,DMA,1964,23951,38892,62843
Dominica,DMA,1965,24337,39407,63744
Dominica,DMA,1966,24757,39971,64728
Dominica,DMA,1967,25195,40565,65760
Dominica,DMA,1968,25663,41202,66865
Dominica,DMA,1969,26147,41860,68007
Dominica,DMA,1970,26651,42244,68895
Dominica,DMA,1971,27404,42026,69430
Dominica,DMA,1972,28132,41738,69870
Dominica,DMA,1973,28880,41454,70334
Dominica,DMA,1974,29649,41173,70822
Dominica,DMA,1975,30424,40876,71300
Dominica,DMA,1976,31199,40549,71748
Dominica,DMA,1977,31957,40185,72142
Dominica,DMA,1978,32698,39780,72478
Dominica,DMA,1979,33426,39342,72768
Dominica,DMA,1980,34124,38854,72978
Dominica,DMA,1981,34856,38076,72932
Dominica,DMA,1982,35967,36659,72626
Dominica,DMA,1983,37043,35226,72269
Dominica,DMA,1984,38119,33817,71936
Dominica,DMA,1985,39170,32426,71596
Dominica,DMA,1986,40181,31034,71215
Dominica,DMA,1987,41152,29656,70808
Dominica,DMA,1988,42096,28301,70397
Dominica,DMA,1989,43000,26975,69975
Dominica,DMA,1990,43828,25653,69481
Dominica,DMA,1991,44583,24558,69141
Dominica,DMA,1992,44625,24487,69112
Dominica,DMA,1993,44722,24447,69169
Dominica,DMA,1994,44802,24396,69198
Dominica,DMA,1995,44864,24337,69201
Dominica,DMA,1996,44901,24265,69166
Dominica,DMA,1997,44906,24175,69081
Dominica,DMA,1998,44873,24065,68938
Dominica,DMA,1999,44777,23921,68698
Dominica,DMA,2000,44606,23740,68346
Dominica,DMA,2001,44560,23593,68153
Dominica,DMA,2002,44841,23421,68262
Dominica,DMA,2003,45168,23274,68442
Dominica,DMA,2004,45464,23110,68574
Dominica,DMA,2005,45738,22936,68674
Dominica,DMA,2006,45990,22752,68742
Dominica,DMA,2007,46219,22556,68775
Dominica,DMA,2008,46429,22353,68782
Dominica,DMA,2009,46637,22150,68787
Dominica,DMA,2010,46818,21937,68755
Dominica,DMA,2011,47012,21730,68742
Dominica,DMA,2012,47316,21572,68888
Dominica,DMA,2013,47473,21346,68819
Dominica,DMA,2014,48060,21311,69371
Dominica,DMA,2015,48710,21297,70007
Dominica,DMA,2016,48968,21107,70075
Dominica,DMA,2017,49410,20993,70403
Dominica,DMA,2018,49918,20905,70823
Dominica,DMA,2019,50561,20867,71428
Dominica,DMA,2020,51181,20814,71995
Dominica,DMA,2021,51699,20713,72412
Dominican Republic,DOM,1960,995706,2302315,3298021
Dominican Republic,DOM,1961,1060426,2347989,3408415
Dominican Republic,DOM,1962,1129378,2391786,3521164
Dominican Republic,DOM,1963,1201704,2434094,3635798
Dominican Republic,DOM,1964,1277512,2474801,3752313
Dominican Republic,DOM,1965,1356061,2512651,3868712
Dominican Republic,DOM,1966,1438263,2548827,3987090
Dominican Republic,DOM,1967,1524654,2584262,4108916
Dominican Republic,DOM,1968,1614207,2616670,4230877
Dominican Republic,DOM,1969,1706663,2646291,4352954
Dominican Republic,DOM,1970,1802612,2673259,4475871
Dominican Republic,DOM,1971,1902080,2697761,4599841
Dominican Republic,DOM,1972,2005064,2719737,4724801
Dominican Republic,DOM,1973,2111574,2739609,4851183
Dominican Republic,DOM,1974,2221742,2756840,4978582
Dominican Republic,DOM,1975,2335130,2771323,5106453
Dominican Republic,DOM,1976,2452118,2783200,5235318
Dominican Republic,DOM,1977,2572446,2792628,5365074
Dominican Republic,DOM,1978,2696119,2799324,5495443
Dominican Republic,DOM,1979,2822777,2803087,5625864
Dominican Republic,DOM,1980,2952150,2803650,5755800
Dominican Republic,DOM,1981,3083927,2801317,5885244
Dominican Republic,DOM,1982,3190946,2824033,6014979
Dominican Republic,DOM,1983,3277878,2869335,6147213
Dominican Republic,DOM,1984,3366956,2915148,6282104
Dominican Republic,DOM,1985,3457139,2960659,6417798
Dominican Republic,DOM,1986,3548512,3005813,6554325
Dominican Republic,DOM,1987,3641643,3051077,6692720
Dominican Republic,DOM,1988,3737218,3096989,6834207
Dominican Republic,DOM,1989,3835877,3144156,6980033
Dominican Republic,DOM,1990,3937064,3191940,7129004
Dominican Republic,DOM,1991,4039295,3239107,7278402
Dominican Republic,DOM,1992,4142005,3285335,7427340
Dominican Republic,DOM,1993,4245405,3330669,7576074
Dominican Republic,DOM,1994,4383487,3340447,7723934
Dominican Republic,DOM,1995,4532820,3336933,7869753
Dominican Republic,DOM,1996,4682476,3329838,8012314
Dominican Republic,DOM,1997,4831039,3319037,8150076
Dominican Republic,DOM,1998,4978137,3303989,8282126
Dominican Republic,DOM,1999,5125303,3286071,8411374
Dominican Republic,DOM,2000,5274195,3266596,8540791
Dominican Republic,DOM,2001,5423785,3245255,8669040
Dominican Republic,DOM,2002,5573543,3221558,8795101
Dominican Republic,DOM,2003,5762670,3157182,8919852
Dominican Republic,DOM,2004,5968735,3074392,9043127
Dominican Republic,DOM,2005,6174304,2990464,9164768
Dominican Republic,DOM,2006,6379152,2905016,9284168
Dominican Republic,DOM,2007,6583425,2818781,9402206
Dominican Republic,DOM,2008,6789862,2733086,9522948
Dominican Republic,DOM,2009,6998896,2649165,9648061
Dominican Republic,DOM,2010,7209913,2565842,9775755
Dominican Republic,DOM,2011,7410669,2493068,9903737
Dominican Republic,DOM,2012,7603609,2427273,10030882
Dominican Republic,DOM,2013,7795435,2361616,10157051
Dominican Republic,DOM,2014,7986119,2295996,10282115
Dominican Republic,DOM,2015,8175446,2230386,10405832
Dominican Republic,DOM,2016,8362698,2164894,10527592
Dominican Republic,DOM,2017,8547288,2099956,10647244
Dominican Republic,DOM,2018,8728047,2037484,10765531
Dominican Republic,DOM,2019,8904426,1977456,10881882
Dominican Republic,DOM,2020,9079123,1920541,10999664
Dominican Republic,DOM,2021,9251516,1866357,11117873
East Asia and Pacific (WB),,1960,236081437,807252200,1043333637
East Asia and Pacific (WB),,1961,242615859,802587200,1045203059
East Asia and Pacific (WB),,1962,251539777,808060400,1059600177
East Asia and Pacific (WB),,1963,262704935,822693950,1085398885
East Asia and Pacific (WB),,1964,274134830,836684400,1110819230
East Asia and Pacific (WB),,1965,280584974,856342100,1136927074
East Asia and Pacific (WB),,1966,287809827,878417860,1166227687
East Asia and Pacific (WB),,1967,295399180,899167940,1194567120
East Asia and Pacific (WB),,1968,303596777,920658940,1224255717
East Asia and Pacific (WB),,1969,312402301,943531300,1255933601
East Asia and Pacific (WB),,1970,321517865,966972600,1288490465
East Asia and Pacific (WB),,1971,331603856,991128770,1322732626
East Asia and Pacific (WB),,1972,340868727,1013342500,1354211227
East Asia and Pacific (WB),,1973,351051420,1033652740,1384704160
East Asia and Pacific (WB),,1974,362064547,1051653700,1413718247
East Asia and Pacific (WB),,1975,370705150,1069239100,1439944250
East Asia and Pacific (WB),,1976,379744914,1084342300,1464087214
East Asia and Pacific (WB),,1977,388466031,1098487800,1486953831
East Asia and Pacific (WB),,1978,400397287,1109663000,1510060287
East Asia and Pacific (WB),,1979,415948603,1117566100,1533514703
East Asia and Pacific (WB),,1980,432047253,1124355700,1556402953
East Asia and Pacific (WB),,1981,449116609,1130932000,1580048609
East Asia and Pacific (WB),,1982,467136540,1138789200,1605925740
East Asia and Pacific (WB),,1983,484008005,1147727700,1631735705
East Asia and Pacific (WB),,1984,501048565,1155209600,1656258165
East Asia and Pacific (WB),,1985,518582287,1162684900,1681267187
East Asia and Pacific (WB),,1986,537040672,1170570400,1707611072
East Asia and Pacific (WB),,1987,556531147,1178896800,1735427947
East Asia and Pacific (WB),,1988,576579622,1186975400,1763555022
East Asia and Pacific (WB),,1989,597030129,1194126200,1791156329
East Asia and Pacific (WB),,1990,617846081,1200401500,1818247581
East Asia and Pacific (WB),,1991,639595023,1205009000,1844604023
East Asia and Pacific (WB),,1992,661333748,1208119900,1869453648
East Asia and Pacific (WB),,1993,683412461,1210182000,1893594461
East Asia and Pacific (WB),,1994,706092158,1211461200,1917553358
East Asia and Pacific (WB),,1995,729151741,1211741000,1940892741
East Asia and Pacific (WB),,1996,752750110,1211292800,1964042910
East Asia and Pacific (WB),,1997,776494435,1210273700,1986768135
East Asia and Pacific (WB),,1998,800536254,1208144000,2008680254
East Asia and Pacific (WB),,1999,824443332,1204549800,2028993132
East Asia and Pacific (WB),,2000,848763919,1199384800,2048148719
East Asia and Pacific (WB),,2001,876880694,1189649300,2066529994
East Asia and Pacific (WB),,2002,906856237,1177113700,2083969937
East Asia and Pacific (WB),,2003,936864583,1163745800,2100610383
East Asia and Pacific (WB),,2004,967022565,1149628900,2116651465
East Asia and Pacific (WB),,2005,997364788,1135153000,2132517788
East Asia and Pacific (WB),,2006,1027397885,1121008000,2148405885
East Asia and Pacific (WB),,2007,1057376409,1106778900,2164155309
East Asia and Pacific (WB),,2008,1087741858,1092172300,2179914158
East Asia and Pacific (WB),,2009,1117968806,1077200900,2195169706
East Asia and Pacific (WB),,2010,1148291153,1061912600,2210203753
East Asia and Pacific (WB),,2011,1177159568,1048832500,2225992068
East Asia and Pacific (WB),,2012,1206613250,1037163460,2243776710
East Asia and Pacific (WB),,2013,1236097364,1025177150,2261274514
East Asia and Pacific (WB),,2014,1265610762,1012621500,2278232262
East Asia and Pacific (WB),,2015,1294988514,999518500,2294507014
East Asia and Pacific (WB),,2016,1324556747,986165100,2310721847
East Asia and Pacific (WB),,2017,1354328520,972806100,2327134620
East Asia and Pacific (WB),,2018,1382700114,958687000,2341387114
East Asia and Pacific (WB),,2019,1409751117,944111100,2353862217
East Asia and Pacific (WB),,2020,1434881782,929058600,2363940382
East Asia and Pacific (WB),,2021,1457042236,913162100,2370204336
East Timor,TLS,1960,47284,421289,468573
East Timor,TLS,1961,48736,427060,475796
East Timor,TLS,1962,50802,432522,483324
East Timor,TLS,1963,52967,438150,491117
East Timor,TLS,1964,55234,443902,499136
East Timor,TLS,1965,57614,449863,507477
East Timor,TLS,1966,60116,456081,516197
East Timor,TLS,1967,62749,462525,525274
East Timor,TLS,1968,65511,469138,534649
East Timor,TLS,1969,68389,475853,544242
East Timor,TLS,1970,71391,482630,554021
East Timor,TLS,1971,74515,489438,563953
East Timor,TLS,1972,77767,496247,574014
East Timor,TLS,1973,81117,502918,584035
East Timor,TLS,1974,84322,507955,592277
East Timor,TLS,1975,87576,512550,600126
East Timor,TLS,1976,91179,518471,609650
East Timor,TLS,1977,94915,524393,619308
East Timor,TLS,1978,98569,529102,627671
East Timor,TLS,1979,102093,532456,634549
East Timor,TLS,1980,105858,536366,642224
East Timor,TLS,1981,109613,539637,649250
East Timor,TLS,1982,113275,541837,655112
East Timor,TLS,1983,117300,545112,662412
East Timor,TLS,1984,121733,549640,671373
East Timor,TLS,1985,126620,555489,682109
East Timor,TLS,1986,131928,562322,694250
East Timor,TLS,1987,137667,570095,707762
East Timor,TLS,1988,143866,578824,722690
East Timor,TLS,1989,150684,589051,739735
East Timor,TLS,1990,158004,600102,758106
East Timor,TLS,1991,163919,608736,772655
East Timor,TLS,1992,168810,614895,783705
East Timor,TLS,1993,173882,621297,795179
East Timor,TLS,1994,179171,627944,807115
East Timor,TLS,1995,184604,634622,819226
East Timor,TLS,1996,190136,641133,831269
East Timor,TLS,1997,195782,647559,843341
East Timor,TLS,1998,201543,653866,855409
East Timor,TLS,1999,207216,659433,866649
East Timor,TLS,2000,213116,665244,878360
East Timor,TLS,2001,219848,673153,893001
East Timor,TLS,2002,227219,682420,909639
East Timor,TLS,2003,234859,691862,926721
East Timor,TLS,2004,243214,702775,945989
East Timor,TLS,2005,252419,716894,969313
East Timor,TLS,2006,262306,732258,994564
East Timor,TLS,2007,272261,747101,1019362
East Timor,TLS,2008,282131,760945,1043076
East Timor,TLS,2009,291841,773699,1065540
East Timor,TLS,2010,301859,786627,1088486
East Timor,TLS,2011,312513,800463,1112976
East Timor,TLS,2012,323419,814257,1137676
East Timor,TLS,2013,334284,827271,1161555
East Timor,TLS,2014,345177,839653,1184830
East Timor,TLS,2015,355594,850219,1205813
East Timor,TLS,2016,365532,859030,1224562
East Timor,TLS,2017,375606,867629,1243235
East Timor,TLS,2018,385847,875998,1261845
East Timor,TLS,2019,396257,884181,1280438
East Timor,TLS,2020,407158,892837,1299995
East Timor,TLS,2021,418673,902269,1320942
Ecuador,ECU,1960,1564540,3053618,4618158
Ecuador,ECU,1961,1637654,3113853,4751507
Ecuador,ECU,1962,1714583,3175842,4890425
Ecuador,ECU,1963,1792525,3241809,5034334
Ecuador,ECU,1964,1872305,3310978,5183283
Ecuador,ECU,1965,1955605,3381746,5337351
Ecuador,ECU,1966,2042335,3453426,5495761
Ecuador,ECU,1967,2132442,3526004,5658446
Ecuador,ECU,1968,2226277,3599386,5825663
Ecuador,ECU,1969,2323492,3673545,5997037
Ecuador,ECU,1970,2424323,3747892,6172215
Ecuador,ECU,1971,2528501,3822443,6350944
Ecuador,ECU,1972,2636450,3897180,6533630
Ecuador,ECU,1973,2748124,3972319,6720443
Ecuador,ECU,1974,2865144,4045979,6911123
Ecuador,ECU,1975,3010224,4095562,7105786
Ecuador,ECU,1976,3161030,4143319,7304349
Ecuador,ECU,1977,3317270,4189395,7506665
Ecuador,ECU,1978,3479284,4233434,7712718
Ecuador,ECU,1979,3647039,4275451,7922490
Ecuador,ECU,1980,3820674,4315171,8135845
Ecuador,ECU,1981,3999894,4352708,8352602
Ecuador,ECU,1982,4184975,4387632,8572607
Ecuador,ECU,1983,4367855,4428018,8795873
Ecuador,ECU,1984,4551010,4471969,9022979
Ecuador,ECU,1985,4739595,4514716,9254311
Ecuador,ECU,1986,4934186,4555910,9490096
Ecuador,ECU,1987,5134094,4595282,9729376
Ecuador,ECU,1988,5338423,4631365,9969788
Ecuador,ECU,1989,5545968,4664217,10210185
Ecuador,ECU,1990,5756815,4693022,10449837
Ecuador,ECU,1991,5953219,4733060,10686279
Ecuador,ECU,1992,6136630,4777592,10914222
Ecuador,ECU,1993,6316767,4816062,11132829
Ecuador,ECU,1994,6496985,4850667,11347652
Ecuador,ECU,1995,6678722,4882961,11561683
Ecuador,ECU,1996,6862246,4912975,11775221
Ecuador,ECU,1997,7047051,4940787,11987838
Ecuador,ECU,1998,7233320,4966373,12199693
Ecuador,ECU,1999,7421907,4990139,12412046
Ecuador,ECU,2000,7613657,5012850,12626507
Ecuador,ECU,2001,7809948,5035573,12845521
Ecuador,ECU,2002,7988495,5082114,13070609
Ecuador,ECU,2003,8155754,5145430,13301184
Ecuador,ECU,2004,8325670,5208923,13534593
Ecuador,ECU,2005,8497612,5272400,13770012
Ecuador,ECU,2006,8672589,5336472,14009061
Ecuador,ECU,2007,8850960,5400875,14251835
Ecuador,ECU,2008,9031505,5465292,14496797
Ecuador,ECU,2009,9213492,5529274,14742766
Ecuador,ECU,2010,9396971,5592614,14989585
Ecuador,ECU,2011,9577064,5660664,15237728
Ecuador,ECU,2012,9752988,5730895,15483883
Ecuador,ECU,2013,9925137,5797852,15722989
Ecuador,ECU,2014,10095187,5862807,15957994
Ecuador,ECU,2015,10267878,5928024,16195902
Ecuador,ECU,2016,10444726,5994859,16439585
Ecuador,ECU,2017,10630944,6066000,16696944
Ecuador,ECU,2018,10859572,6156100,17015672
Ecuador,ECU,2019,11097565,6246175,17343740
Ecuador,ECU,2020,11285898,6302697,17588595
Ecuador,ECU,2021,11454802,6342935,17797737
Egypt,EGY,1960,10236343,16798156,27034499
Egypt,EGY,1961,10619664,17128204,27747868
Egypt,EGY,1962,11002055,17482968,28485023
Egypt,EGY,1963,11399188,17846748,29245936
Egypt,EGY,1964,11809781,18216868,30026649
Egypt,EGY,1965,12230618,18587852,30818470
Egypt,EGY,1966,12658530,18954602,31613132
Egypt,EGY,1967,13092675,19315740,32408415
Egypt,EGY,1968,13533543,19671086,33204629
Egypt,EGY,1969,13978117,20017838,33995955
Egypt,EGY,1970,14426524,20355462,34781986
Egypt,EGY,1971,14875906,20680064,35555970
Egypt,EGY,1972,15331584,20999184,36330768
Egypt,EGY,1973,15799716,21321060,37120776
Egypt,EGY,1974,16281992,21648382,37930374
Egypt,EGY,1975,16786338,21989246,38775584
Egypt,EGY,1976,17309189,22339860,39649049
Egypt,EGY,1977,17776940,22800416,40577356
Egypt,EGY,1978,18221376,23355260,41576636
Egypt,EGY,1979,18690922,23941536,42632458
Egypt,EGY,1980,19187242,24561314,43748556
Egypt,EGY,1981,19699239,25200334,44899573
Egypt,EGY,1982,20228307,25860340,46088647
Egypt,EGY,1983,20791100,26562564,47353664
Egypt,EGY,1984,21379667,27296776,48676443
Egypt,EGY,1985,21984749,28051094,50035843
Egypt,EGY,1986,22603043,28821270,51424313
Egypt,EGY,1987,23185186,29656132,52841318
Egypt,EGY,1988,23752312,30546134,54298446
Egypt,EGY,1989,24320042,31445800,55765842
Egypt,EGY,1990,24875777,32338852,57214629
Egypt,EGY,1991,25404952,33206080,58611032
Egypt,EGY,1992,25922508,34066630,59989138
Egypt,EGY,1993,26442838,34939360,61382198
Egypt,EGY,1994,26959715,35816132,62775847
Egypt,EGY,1995,27472420,36694490,64166910
Egypt,EGY,1996,27983881,37581310,65565191
Egypt,EGY,1997,28578184,38415544,66993728
Egypt,EGY,1998,29229185,39216824,68446009
Egypt,EGY,1999,29885622,40022264,69907886
Egypt,EGY,2000,30544806,40826564,71371370
Egypt,EGY,2001,31212951,41641310,72854261
Egypt,EGY,2002,31906739,42487020,74393759
Egypt,EGY,2003,32614852,43348470,75963322
Egypt,EGY,2004,33319914,44202510,77522424
Egypt,EGY,2005,34023734,45051576,79075310
Egypt,EGY,2006,34729618,45900052,80629670
Egypt,EGY,2007,35418195,46800560,82218755
Egypt,EGY,2008,36101887,47742896,83844783
Egypt,EGY,2009,36798803,48702260,85501063
Egypt,EGY,2010,37535116,49717296,87252412
Egypt,EGY,2011,38356023,50844030,89200053
Egypt,EGY,2012,39184092,52056284,91240376
Egypt,EGY,2013,40052578,53325310,93377888
Egypt,EGY,2014,40950796,54641530,95592326
Egypt,EGY,2015,41811127,55912670,97723797
Egypt,EGY,2016,42639712,57144320,99784032
Egypt,EGY,2017,43469157,58320228,101789385
Egypt,EGY,2018,44301456,59439308,103740764
Egypt,EGY,2019,45130858,60487812,105618670
Egypt,EGY,2020,45976808,61488330,107465138
Egypt,EGY,2021,46831955,62430224,109262179
El Salvador,SLV,1960,1065983,1713344,2779327
El Salvador,SLV,1961,1101447,1757449,2858896
El Salvador,SLV,1962,1134821,1803000,2937821
El Salvador,SLV,1963,1167635,1847250,3014885
El Salvador,SLV,1964,1201855,1893315,3095170
El Salvador,SLV,1965,1237813,1941693,3179506
El Salvador,SLV,1966,1274988,1991448,3266436
El Salvador,SLV,1967,1312793,2041818,3354611
El Salvador,SLV,1968,1350994,2092257,3443251
El Salvador,SLV,1969,1388973,2141985,3530958
El Salvador,SLV,1970,1427333,2191757,3619090
El Salvador,SLV,1971,1466295,2241715,3708010
El Salvador,SLV,1972,1520877,2277232,3798109
El Salvador,SLV,1973,1577382,2313257,3890639
El Salvador,SLV,1974,1635293,2348756,3984049
El Salvador,SLV,1975,1693931,2382820,4076751
El Salvador,SLV,1976,1752511,2414379,4166890
El Salvador,SLV,1977,1811864,2444835,4256699
El Salvador,SLV,1978,1872264,2474258,4346522
El Salvador,SLV,1979,1932185,2500856,4433041
El Salvador,SLV,1980,1988420,2520572,4508992
El Salvador,SLV,1981,2029477,2519696,4549173
El Salvador,SLV,1982,2075799,2524105,4599904
El Salvador,SLV,1983,2140464,2549216,4689680
El Salvador,SLV,1984,2207472,2574747,4782219
El Salvador,SLV,1985,2276324,2600433,4876757
El Salvador,SLV,1986,2345963,2624825,4970788
El Salvador,SLV,1987,2417764,2649436,5067200
El Salvador,SLV,1988,2493910,2676530,5170440
El Salvador,SLV,1989,2569738,2701087,5270825
El Salvador,SLV,1990,2644624,2722555,5367179
El Salvador,SLV,1991,2719285,2741785,5461070
El Salvador,SLV,1992,2793592,2758614,5552206
El Salvador,SLV,1993,2895285,2735702,5630987
El Salvador,SLV,1994,3000459,2692579,5693038
El Salvador,SLV,1995,3103336,2644859,5748195
El Salvador,SLV,1996,3203963,2593177,5797140
El Salvador,SLV,1997,3303252,2539386,5842638
El Salvador,SLV,1998,3401578,2483505,5885083
El Salvador,SLV,1999,3456982,2466870,5923852
El Salvador,SLV,2000,3510261,2448221,5958482
El Salvador,SLV,2001,3560761,2427334,5988095
El Salvador,SLV,2002,3607607,2403668,6011275
El Salvador,SLV,2003,3649920,2376929,6026849
El Salvador,SLV,2004,3688208,2347447,6035655
El Salvador,SLV,2005,3722193,2315624,6037817
El Salvador,SLV,2006,3752635,2281801,6034436
El Salvador,SLV,2007,3794143,2249988,6044131
El Salvador,SLV,2008,3864044,2204055,6068099
El Salvador,SLV,2009,3933080,2158108,6091188
El Salvador,SLV,2010,4001758,2112276,6114034
El Salvador,SLV,2011,4070597,2066752,6137349
El Salvador,SLV,2012,4139585,2021704,6161289
El Salvador,SLV,2013,4208463,1977179,6185642
El Salvador,SLV,2014,4276749,1932777,6209526
El Salvador,SLV,2015,4343053,1888013,6231066
El Salvador,SLV,2016,4406672,1843838,6250510
El Salvador,SLV,2017,4466558,1800096,6266654
El Salvador,SLV,2018,4520410,1755932,6276342
El Salvador,SLV,2019,4568607,1711610,6280217
El Salvador,SLV,2020,4621633,1671098,6292731
El Salvador,SLV,2021,4679934,1634233,6314167
Equatorial Guinea,GNQ,1960,68273,199078,267351
Equatorial Guinea,GNQ,1961,71181,201083,272264
Equatorial Guinea,GNQ,1962,72797,204693,277490
Equatorial Guinea,GNQ,1963,74499,208519,283018
Equatorial Guinea,GNQ,1964,76294,212558,288852
Equatorial Guinea,GNQ,1965,78184,216826,295010
Equatorial Guinea,GNQ,1966,80179,221338,301517
Equatorial Guinea,GNQ,1967,82280,226094,308374
Equatorial Guinea,GNQ,1968,84422,230903,315325
Equatorial Guinea,GNQ,1969,85652,233194,318846
Equatorial Guinea,GNQ,1970,85432,231523,316955
Equatorial Guinea,GNQ,1971,84367,227585,311952
Equatorial Guinea,GNQ,1972,82863,222499,305362
Equatorial Guinea,GNQ,1973,81150,216900,298050
Equatorial Guinea,GNQ,1974,79378,211180,290558
Equatorial Guinea,GNQ,1975,77642,205620,283262
Equatorial Guinea,GNQ,1976,75906,200094,276000
Equatorial Guinea,GNQ,1977,74884,196493,271377
Equatorial Guinea,GNQ,1978,74995,195871,270866
Equatorial Guinea,GNQ,1979,76094,197831,273925
Equatorial Guinea,GNQ,1980,78741,203768,282509
Equatorial Guinea,GNQ,1981,83042,213908,296950
Equatorial Guinea,GNQ,1982,88591,227150,315741
Equatorial Guinea,GNQ,1983,94797,241947,336744
Equatorial Guinea,GNQ,1984,103919,254076,357995
Equatorial Guinea,GNQ,1985,113287,265092,378379
Equatorial Guinea,GNQ,1986,122643,274633,397276
Equatorial Guinea,GNQ,1987,131967,282802,414769
Equatorial Guinea,GNQ,1988,141474,290113,431587
Equatorial Guinea,GNQ,1989,151364,297056,448420
Equatorial Guinea,GNQ,1990,161755,303794,465549
Equatorial Guinea,GNQ,1991,172714,310428,483142
Equatorial Guinea,GNQ,1992,184320,317014,501334
Equatorial Guinea,GNQ,1993,196608,323628,520236
Equatorial Guinea,GNQ,1994,209684,330308,539992
Equatorial Guinea,GNQ,1995,227066,333674,560740
Equatorial Guinea,GNQ,1996,245770,336803,582573
Equatorial Guinea,GNQ,1997,265803,339767,605570
Equatorial Guinea,GNQ,1998,287259,342475,629734
Equatorial Guinea,GNQ,1999,310156,344873,655029
Equatorial Guinea,GNQ,2000,336269,348708,684977
Equatorial Guinea,GNQ,2001,365619,353651,719270
Equatorial Guinea,GNQ,2002,396461,357654,754115
Equatorial Guinea,GNQ,2003,428852,360829,789681
Equatorial Guinea,GNQ,2004,463031,363324,826355
Equatorial Guinea,GNQ,2005,499293,365433,864726
Equatorial Guinea,GNQ,2006,538099,367319,905418
Equatorial Guinea,GNQ,2007,579725,369089,948814
Equatorial Guinea,GNQ,2008,624295,370676,994971
Equatorial Guinea,GNQ,2009,671695,371991,1043686
Equatorial Guinea,GNQ,2010,721729,372795,1094524
Equatorial Guinea,GNQ,2011,772460,372128,1144588
Equatorial Guinea,GNQ,2012,823609,370027,1193636
Equatorial Guinea,GNQ,2013,865086,378855,1243941
Equatorial Guinea,GNQ,2014,907703,387480,1295183
Equatorial Guinea,GNQ,2015,951178,395795,1346973
Equatorial Guinea,GNQ,2016,995169,403758,1398927
Equatorial Guinea,GNQ,2017,1039364,411330,1450694
Equatorial Guinea,GNQ,2018,1083654,418437,1502091
Equatorial Guinea,GNQ,2019,1127920,425111,1553031
Equatorial Guinea,GNQ,2020,1166712,429337,1596049
Equatorial Guinea,GNQ,2021,1202330,432136,1634466
Eritrea,ERI,1960,97360,896208,993568
Eritrea,ERI,1961,102853,914079,1016932
Eritrea,ERI,1962,108717,932835,1041552
Eritrea,ERI,1963,114969,952326,1067295
Eritrea,ERI,1964,121603,972439,1094042
Eritrea,ERI,1965,128619,993120,1121739
Eritrea,ERI,1966,136053,1014211,1150264
Eritrea,ERI,1967,143906,1035648,1179554
Eritrea,ERI,1968,149483,1060119,1209602
Eritrea,ERI,1969,155281,1085281,1240562
Eritrea,ERI,1970,161359,1111389,1272748
Eritrea,ERI,1971,167734,1138500,1306234
Eritrea,ERI,1972,174389,1166449,1340838
Eritrea,ERI,1973,181328,1195188,1376516
Eritrea,ERI,1974,188538,1224682,1413220
Eritrea,ERI,1975,196027,1254840,1450867
Eritrea,ERI,1976,203845,1285811,1489656
Eritrea,ERI,1977,211985,1317817,1529802
Eritrea,ERI,1978,220486,1350707,1571193
Eritrea,ERI,1979,229341,1384488,1613829
Eritrea,ERI,1980,238584,1419398,1657982
Eritrea,ERI,1981,248276,1455513,1703789
Eritrea,ERI,1982,258367,1492678,1751045
Eritrea,ERI,1983,268892,1530922,1799814
Eritrea,ERI,1984,280805,1568789,1849594
Eritrea,ERI,1985,299264,1599979,1899243
Eritrea,ERI,1986,318781,1630830,1949611
Eritrea,ERI,1987,339300,1661055,2000355
Eritrea,ERI,1988,360908,1690638,2051546
Eritrea,ERI,1989,383408,1718723,2102131
Eritrea,ERI,1990,406450,1743510,2149960
Eritrea,ERI,1991,399483,1639737,2039220
Eritrea,ERI,1992,389879,1531274,1921153
Eritrea,ERI,1993,416395,1565024,1981419
Eritrea,ERI,1994,444346,1598154,2042500
Eritrea,ERI,1995,485677,1671543,2157220
Eritrea,ERI,1996,527371,1736702,2264073
Eritrea,ERI,1997,551991,1739570,2291561
Eritrea,ERI,1998,578435,1744318,2322753
Eritrea,ERI,1999,606439,1750038,2356477
Eritrea,ERI,2000,636195,1756685,2392880
Eritrea,ERI,2001,675922,1786005,2461927
Eritrea,ERI,2002,721965,1825459,2547424
Eritrea,ERI,2003,775957,1877433,2653390
Eritrea,ERI,2004,833474,1929666,2763140
Eritrea,ERI,2005,880640,1951092,2831732
Eritrea,ERI,2006,923099,1956994,2880093
Eritrea,ERI,2007,966133,1960035,2926168
Eritrea,ERI,2008,1021965,1983814,3005779
Eritrea,ERI,2009,1066563,2017325,3083888
Eritrea,ERI,2010,1107213,2040514,3147727
Eritrea,ERI,2011,1147380,2060190,3207570
Eritrea,ERI,2012,1183034,2069562,3252596
Eritrea,ERI,2013,1218964,2077403,3296367
Eritrea,ERI,2014,1249275,2074150,3323425
Eritrea,ERI,2015,1276083,2063923,3340006
Eritrea,ERI,2016,1306640,2058647,3365287
Eritrea,ERI,2017,1340124,2056809,3396933
Eritrea,ERI,2018,1380906,2064468,3445374
Eritrea,ERI,2019,1424439,2074379,3498818
Eritrea,ERI,2020,1470245,2085623,3555868
Eritrea,ERI,2021,1519988,2100324,3620312
Estonia,EST,1960,697034,514503,1211537
Estonia,EST,1961,714269,510808,1225077
Estonia,EST,1962,733452,508171,1241623
Estonia,EST,1963,753250,505607,1258857
Estonia,EST,1964,773863,503223,1277086
Estonia,EST,1965,794190,500376,1294566
Estonia,EST,1966,812599,495998,1308597
Estonia,EST,1967,828812,490134,1318946
Estonia,EST,1968,846346,484868,1331214
Estonia,EST,1969,865089,480160,1345249
Estonia,EST,1970,883329,476747,1360076
Estonia,EST,1971,901671,475284,1376955
Estonia,EST,1972,919299,473219,1392518
Estonia,EST,1973,935590,470361,1405951
Estonia,EST,1974,951152,467017,1418169
Estonia,EST,1975,966085,463267,1429352
Estonia,EST,1976,980438,459138,1439576
Estonia,EST,1977,995091,455120,1450211
Estonia,EST,1978,1009340,450848,1460188
Estonia,EST,1979,1020447,447886,1468333
Estonia,EST,1980,1029784,447435,1477219
Estonia,EST,1981,1040236,447430,1487666
Estonia,EST,1982,1050928,447486,1498414
Estonia,EST,1983,1061357,447388,1508745
Estonia,EST,1984,1071506,447111,1518617
Estonia,EST,1985,1081872,446909,1528781
Estonia,EST,1986,1093150,447040,1540190
Estonia,EST,1987,1104917,447304,1552221
Estonia,EST,1988,1115040,446860,1561900
Estonia,EST,1989,1119881,448250,1568131
Estonia,EST,1990,1117738,451436,1569174
Estonia,EST,1991,1109251,452063,1561314
Estonia,EST,1992,1086348,446743,1533091
Estonia,EST,1993,1055960,438168,1494128
Estonia,EST,1994,1030882,431632,1462514
Estonia,EST,1995,1009954,426680,1436634
Estonia,EST,1996,992487,423107,1415594
Estonia,EST,1997,978597,420938,1399535
Estonia,EST,1998,966608,419548,1386156
Estonia,EST,1999,966817,423427,1390244
Estonia,EST,2000,969061,427924,1396985
Estonia,EST,2001,961159,426956,1388115
Estonia,EST,2002,953352,425998,1379350
Estonia,EST,2003,945646,425074,1370720
Estonia,EST,2004,938279,424271,1362550
Estonia,EST,2005,931205,423570,1354775
Estonia,EST,2006,924006,422804,1346810
Estonia,EST,2007,918084,422596,1340680
Estonia,EST,2008,913914,423176,1337090
Estonia,EST,2009,910446,424069,1334515
Estonia,EST,2010,906655,424820,1331475
Estonia,EST,2011,902194,425245,1327439
Estonia,EST,2012,899089,423607,1322696
Estonia,EST,2013,897846,420151,1317997
Estonia,EST,2014,897427,417118,1314545
Estonia,EST,2015,899949,415458,1315407
Estonia,EST,2016,902145,413645,1315790
Estonia,EST,2017,905267,412117,1317384
Estonia,EST,2018,910578,411399,1321977
Estonia,EST,2019,916236,410662,1326898
Estonia,EST,2020,920415,409107,1329522
Estonia,EST,2021,923866,407066,1330932
Eswatini,SWZ,1960,13502,331563,345065
Eswatini,SWZ,1961,15301,337670,352971
Eswatini,SWZ,1962,17331,343739,361070
Eswatini,SWZ,1963,19629,349898,369527
Eswatini,SWZ,1964,22242,356289,378531
Eswatini,SWZ,1965,25217,363100,388317
Eswatini,SWZ,1966,28546,370315,398861
Eswatini,SWZ,1967,31661,377977,409638
Eswatini,SWZ,1968,35076,385297,420373
Eswatini,SWZ,1969,38827,392539,431366
Eswatini,SWZ,1970,42980,399885,442865
Eswatini,SWZ,1971,47575,407338,454913
Eswatini,SWZ,1972,52661,414851,467512
Eswatini,SWZ,1973,58257,422411,480668
Eswatini,SWZ,1974,64464,430160,494624
Eswatini,SWZ,1975,71355,438180,509535
Eswatini,SWZ,1976,79013,446444,525457
Eswatini,SWZ,1977,83920,458408,542328
Eswatini,SWZ,1978,88534,471702,560236
Eswatini,SWZ,1979,93448,485643,579091
Eswatini,SWZ,1980,98631,499933,598564
Eswatini,SWZ,1981,103671,512539,616210
Eswatini,SWZ,1982,108971,525468,634439
Eswatini,SWZ,1983,114930,540575,655505
Eswatini,SWZ,1984,121217,556086,677303
Eswatini,SWZ,1985,128300,574100,702400
Eswatini,SWZ,1986,136107,594043,730150
Eswatini,SWZ,1987,144314,614355,758669
Eswatini,SWZ,1988,154200,640234,794434
Eswatini,SWZ,1989,163563,662389,825952
Eswatini,SWZ,1990,172527,681484,854011
Eswatini,SWZ,1991,183343,706369,889712
Eswatini,SWZ,1992,194451,730714,925165
Eswatini,SWZ,1993,204363,749088,953451
Eswatini,SWZ,1994,208458,745279,953737
Eswatini,SWZ,1995,212513,741060,953573
Eswatini,SWZ,1996,221218,752369,973587
Eswatini,SWZ,1997,228671,762063,990734
Eswatini,SWZ,1998,230674,774484,1005158
Eswatini,SWZ,1999,232361,786009,1018370
Eswatini,SWZ,2000,233778,796718,1030496
Eswatini,SWZ,2001,234887,806509,1041396
Eswatini,SWZ,2002,235644,815165,1050809
Eswatini,SWZ,2003,236069,822728,1058797
Eswatini,SWZ,2004,236237,829527,1065764
Eswatini,SWZ,2005,236222,835664,1071886
Eswatini,SWZ,2006,236132,841603,1077735
Eswatini,SWZ,2007,236628,847380,1084008
Eswatini,SWZ,2008,240262,849608,1089870
Eswatini,SWZ,2009,243744,851142,1094886
Eswatini,SWZ,2010,247262,852658,1099920
Eswatini,SWZ,2011,250919,854452,1105371
Eswatini,SWZ,2012,253954,857490,1111444
Eswatini,SWZ,2013,257202,861117,1118319
Eswatini,SWZ,2014,260626,865239,1125865
Eswatini,SWZ,2015,264207,869729,1133936
Eswatini,SWZ,2016,268025,874499,1142524
Eswatini,SWZ,2017,272016,879374,1151390
Eswatini,SWZ,2018,276170,884258,1160428
Eswatini,SWZ,2019,280485,889128,1169613
Eswatini,SWZ,2020,285376,895279,1180655
Eswatini,SWZ,2021,290545,901726,1192271
Ethiopia,ETH,1960,1398516,20341194,21739710
Ethiopia,ETH,1961,1481731,20799944,22281675
Ethiopia,ETH,1962,1570857,21281300,22852157
Ethiopia,ETH,1963,1665815,21783164,23448979
Ethiopia,ETH,1964,1767491,22306204,24073695
Ethiopia,ETH,1965,1876076,22851430,24727506
Ethiopia,ETH,1966,1989607,23388038,25377645
Ethiopia,ETH,1967,2110179,23941416,26051595
Ethiopia,ETH,1968,2211917,24566736,26778653
Ethiopia,ETH,1969,2318609,25211780,27530389
Ethiopia,ETH,1970,2431112,25877134,28308246
Ethiopia,ETH,1971,2547960,26551634,29099594
Ethiopia,ETH,1972,2668698,27222630,29891328
Ethiopia,ETH,1973,2793797,27900520,30694317
Ethiopia,ETH,1974,2921828,28566784,31488612
Ethiopia,ETH,1975,3051113,29201670,32252783
Ethiopia,ETH,1976,3188520,29873696,33062216
Ethiopia,ETH,1977,3312220,30382798,33695018
Ethiopia,ETH,1978,3432758,30826308,34259066
Ethiopia,ETH,1979,3550266,31208556,34758822
Ethiopia,ETH,1980,3637823,31307646,34945469
Ethiopia,ETH,1981,3800379,32018464,35818843
Ethiopia,ETH,1982,4023884,33189508,37213392
Ethiopia,ETH,1983,4213518,34021668,38235186
Ethiopia,ETH,1984,4403269,34799620,39202889
Ethiopia,ETH,1985,4613952,35672012,40285964
Ethiopia,ETH,1986,4841566,36613744,41455310
Ethiopia,ETH,1987,5103240,37748716,42851956
Ethiopia,ETH,1988,5405036,39106500,44511536
Ethiopia,ETH,1989,5719059,40476896,46195955
Ethiopia,ETH,1990,6042692,41835380,47878072
Ethiopia,ETH,1991,6425449,43511980,49937429
Ethiopia,ETH,1992,6821835,45189720,52011555
Ethiopia,ETH,1993,7191947,46599724,53791671
Ethiopia,ETH,1994,7579366,48040844,55620210
Ethiopia,ETH,1995,7947281,49529256,57476537
Ethiopia,ETH,1996,8312232,51035416,59347648
Ethiopia,ETH,1997,8686581,52546900,61233481
Ethiopia,ETH,1998,9072083,54064410,63136493
Ethiopia,ETH,1999,9470740,55606840,65077580
Ethiopia,ETH,2000,9880497,57151370,67031867
Ethiopia,ETH,2001,10302456,58716476,69018932
Ethiopia,ETH,2002,10744849,60328370,71073219
Ethiopia,ETH,2003,11202149,61966690,73168839
Ethiopia,ETH,2004,11674671,63626356,75301027
Ethiopia,ETH,2005,12162781,65307160,77469941
Ethiopia,ETH,2006,12670080,67020970,79691050
Ethiopia,ETH,2007,13214505,68781680,81996185
Ethiopia,ETH,2008,13927358,70429740,84357098
Ethiopia,ETH,2009,14670369,72085220,86755589
Ethiopia,ETH,2010,15455093,73782696,89237789
Ethiopia,ETH,2011,16283910,75534020,91817930
Ethiopia,ETH,2012,17152352,77298930,94451282
Ethiopia,ETH,2013,18033421,79050940,97084361
Ethiopia,ETH,2014,18949891,80796870,99746761
Ethiopia,ETH,2015,19908240,82563656,102471896
Ethiopia,ETH,2016,20917553,84375670,105293223
Ethiopia,ETH,2017,21975004,86222940,108197944
Ethiopia,ETH,2018,23073805,88055630,111129435
Ethiopia,ETH,2019,24222096,89898500,114120596
Ethiopia,ETH,2020,25424568,91766344,117190912
Ethiopia,ETH,2021,26671558,93611470,120283028
Europe and Central Asia (WB),,1960,369742957,295583700,665326657
Europe and Central Asia (WB),,1961,377560021,295431800,672991821
Europe and Central Asia (WB),,1962,385532320,295283040,680815360
Europe and Central Asia (WB),,1963,393773598,294887100,688660698
Europe and Central Asia (WB),,1964,402098956,294410660,696509616
Europe and Central Asia (WB),,1965,410461367,293693760,704155127
Europe and Central Asia (WB),,1966,418401012,292570080,710971092
Europe and Central Asia (WB),,1967,426290511,291458620,717749131
Europe and Central Asia (WB),,1968,433978945,290309200,724288145
Europe and Central Asia (WB),,1969,441395403,289200960,730596363
Europe and Central Asia (WB),,1970,448376558,287802940,736179498
Europe and Central Asia (WB),,1971,455274315,286438430,741712745
Europe and Central Asia (WB),,1972,462495859,285312200,747808059
Europe and Central Asia (WB),,1973,469542436,284150530,753692966
Europe and Central Asia (WB),,1974,476418941,282922980,759341921
Europe and Central Asia (WB),,1975,482974408,281826300,764800708
Europe and Central Asia (WB),,1976,489332033,280860670,770192703
Europe and Central Asia (WB),,1977,495688203,279800480,775488683
Europe and Central Asia (WB),,1978,502102323,278658080,780760403
Europe and Central Asia (WB),,1979,508259958,277751520,786011478
Europe and Central Asia (WB),,1980,514177594,277191940,791369534
Europe and Central Asia (WB),,1981,520220711,276315420,796536131
Europe and Central Asia (WB),,1982,525750554,275543700,801294254
Europe and Central Asia (WB),,1983,531064606,274845250,805909856
Europe and Central Asia (WB),,1984,536453114,274273800,810726914
Europe and Central Asia (WB),,1985,541848901,273783000,815631901
Europe and Central Asia (WB),,1986,547341719,273371100,820712819
Europe and Central Asia (WB),,1987,553109214,272804700,825913914
Europe and Central Asia (WB),,1988,558937075,272237760,831174835
Europe and Central Asia (WB),,1989,563851313,272128740,835980053
Europe and Central Asia (WB),,1990,567888585,272279940,840168525
Europe and Central Asia (WB),,1991,571886435,272580100,844466535
Europe and Central Asia (WB),,1992,575142816,272741900,847884716
Europe and Central Asia (WB),,1993,577991754,272778700,850770454
Europe and Central Asia (WB),,1994,580386464,272509200,852895664
Europe and Central Asia (WB),,1995,582428803,272053760,854482563
Europe and Central Asia (WB),,1996,584435737,271714500,856150237
Europe and Central Asia (WB),,1997,586321067,271304420,857625487
Europe and Central Asia (WB),,1998,588128966,270781150,858910116
Europe and Central Asia (WB),,1999,589942445,270144160,860086605
Europe and Central Asia (WB),,2000,591738229,269347970,861086199
Europe and Central Asia (WB),,2001,593846263,268361710,862207973
Europe and Central Asia (WB),,2002,596658392,267113470,863771862
Europe and Central Asia (WB),,2003,600019903,265978080,865997983
Europe and Central Asia (WB),,2004,603649419,264916800,868566219
Europe and Central Asia (WB),,2005,607362884,263845040,871207924
Europe and Central Asia (WB),,2006,611119312,262789090,873908402
Europe and Central Asia (WB),,2007,615204410,261829220,877033630
Europe and Central Asia (WB),,2008,619583863,261026200,880610063
Europe and Central Asia (WB),,2009,623834147,260250610,884084757
Europe and Central Asia (WB),,2010,627940793,259506350,887447143
Europe and Central Asia (WB),,2011,630961782,258526860,889488642
Europe and Central Asia (WB),,2012,634989639,257965330,892954969
Europe and Central Asia (WB),,2013,639571136,257646670,897217806
Europe and Central Asia (WB),,2014,644384592,257403680,901788272
Europe and Central Asia (WB),,2015,649265373,257069570,906334943
Europe and Central Asia (WB),,2016,654007193,256589950,910597143
Europe and Central Asia (WB),,2017,658228229,255836200,914064429
Europe and Central Asia (WB),,2018,662118330,254867140,916985470
Europe and Central Asia (WB),,2019,665705220,253685630,919390850
Europe and Central Asia (WB),,2020,668965453,252348290,921313743
Europe and Central Asia (WB),,2021,671416247,250574930,921991177
European Union (27),,1960,209446113,147501020,356947133
European Union (27),,1961,213138965,146798930,359937895
European Union (27),,1962,216891776,146107000,362998776
European Union (27),,1963,220911982,145241000,366152982
European Union (27),,1964,225015415,144371940,369387355
European Union (27),,1965,229116244,143417600,372533844
European Union (27),,1966,233123801,142439360,375563161
European Union (27),,1967,236994817,141517760,378512577
European Union (27),,1968,240654734,140626180,381280914
European Union (27),,1969,244086969,139871550,383958519
European Union (27),,1970,247184362,138932110,386116472
European Union (27),,1971,250269235,137960160,388229395
European Union (27),,1972,253571937,137287420,390859357
European Union (27),,1973,256754347,136631920,393386267
European Union (27),,1974,259819805,135958850,395778655
European Union (27),,1975,262682363,135413800,398096163
European Union (27),,1976,265308576,134902780,400211356
European Union (27),,1977,267922565,134248100,402170665
European Union (27),,1978,270538633,133518210,404056843
European Union (27),,1979,273076490,132803460,405879950
European Union (27),,1980,275601412,132159416,407760828
European Union (27),,1981,277886514,131604160,409490674
European Union (27),,1982,279636918,131238370,410875288
European Union (27),,1983,281045281,130911420,411956701
European Union (27),,1984,282233687,130657624,412891311
European Union (27),,1985,283410538,130456424,413866962
European Union (27),,1986,284808442,130188104,414996546
European Union (27),,1987,286504088,129695160,416199248
European Union (27),,1988,288274425,129254104,417528529
European Union (27),,1989,289884480,129041290,418925770
European Union (27),,1990,291554303,128754570,420308873
European Union (27),,1991,293361569,128383160,421744729
European Union (27),,1992,294879155,128093280,422972435
European Union (27),,1993,296388743,127959020,424347763
European Union (27),,1994,297725539,127681310,425406849
European Union (27),,1995,298889206,127322930,426212136
European Union (27),,1996,299973998,126932936,426906934
European Union (27),,1997,301001415,126548020,427549435
European Union (27),,1998,301968268,126154056,428122324
European Union (27),,1999,303052374,125776376,428828750
European Union (27),,2000,304085189,125257260,429342449
European Union (27),,2001,305289150,124620990,429910140
European Union (27),,2002,306973917,123924220,430898137
European Union (27),,2003,309030225,123404584,432434809
European Union (27),,2004,311139276,122920650,434059926
European Union (27),,2005,313196512,122403880,435600392
European Union (27),,2006,315160438,121854424,437014862
European Union (27),,2007,317183435,121300640,438484075
European Union (27),,2008,319163672,120728540,439892212
European Union (27),,2009,320838559,120095970,440934529
European Union (27),,2010,322210410,119342140,441552550
European Union (27),,2011,322501582,118268100,440769682
European Union (27),,2012,323810708,117609170,441419878
European Union (27),,2013,325407780,117088390,442496170
European Union (27),,2014,327011738,116589630,443601368
European Union (27),,2015,328571822,115998230,444570052
European Union (27),,2016,330147530,115367890,445515420
European Union (27),,2017,331569232,114645950,446215182
European Union (27),,2018,333091521,113909576,447001097
European Union (27),,2019,334356258,113010936,447367194
European Union (27),,2020,335592576,112099736,447692312
European Union (27),,2021,336283387,110916420,447199807
Faeroe Islands,,1960,7303,26851,34154
Faeroe Islands,,1961,7655,26917,34572
Faeroe Islands,,1962,8028,26935,34963
Faeroe Islands,,1963,8423,26962,35385
Faeroe Islands,,1964,8842,26999,35841
Faeroe Islands,,1965,9287,27059,36346
Faeroe Islands,,1966,9695,27130,36825
Faeroe Islands,,1967,9950,27284,37234
Faeroe Islands,,1968,10206,27424,37630
Faeroe Islands,,1969,10462,27549,38011
Faeroe Islands,,1970,10738,27678,38416
Faeroe Islands,,1971,11043,27818,38861
Faeroe Islands,,1972,11354,27950,39304
Faeroe Islands,,1973,11670,28076,39746
Faeroe Islands,,1974,11993,28196,40189
Faeroe Islands,,1975,12320,28306,40626
Faeroe Islands,,1976,12651,28403,41054
Faeroe Islands,,1977,12986,28495,41481
Faeroe Islands,,1978,13158,28807,41965
Faeroe Islands,,1979,13292,29214,42506
Faeroe Islands,,1980,13427,29627,43054
Faeroe Islands,,1981,13564,30049,43613
Faeroe Islands,,1982,13698,30466,44164
Faeroe Islands,,1983,13817,30852,44669
Faeroe Islands,,1984,13924,31211,45135
Faeroe Islands,,1985,14022,31553,45575
Faeroe Islands,,1986,14117,31894,46011
Faeroe Islands,,1987,14221,32256,46477
Faeroe Islands,,1988,14330,32629,46959
Faeroe Islands,,1989,14452,33038,47490
Faeroe Islands,,1990,14526,32953,47479
Faeroe Islands,,1991,14583,32227,46810
Faeroe Islands,,1992,14663,31342,46005
Faeroe Islands,,1993,14699,30397,45096
Faeroe Islands,,1994,14709,29422,44131
Faeroe Islands,,1995,14925,28880,43805
Faeroe Islands,,1996,15370,28768,44138
Faeroe Islands,,1997,15731,28764,44495
Faeroe Islands,,1998,15996,28869,44865
Faeroe Islands,,1999,16210,28993,45203
Faeroe Islands,,2000,16591,29069,45660
Faeroe Islands,,2001,17192,29053,46245
Faeroe Islands,,2002,17799,29014,46813
Faeroe Islands,,2003,18347,29045,47392
Faeroe Islands,,2004,18834,29155,47989
Faeroe Islands,,2005,19211,29080,48291
Faeroe Islands,,2006,19396,28917,48313
Faeroe Islands,,2007,19509,28852,48361
Faeroe Islands,,2008,19624,28787,48411
Faeroe Islands,,2009,19726,28703,48429
Faeroe Islands,,2010,19812,28598,48410
Faeroe Islands,,2011,19881,28505,48386
Faeroe Islands,,2012,19950,28442,48392
Faeroe Islands,,2013,20027,28391,48418
Faeroe Islands,,2014,20113,28352,48465
Faeroe Islands,,2015,20326,28490,48816
Faeroe Islands,,2016,20680,28820,49500
Faeroe Islands,,2017,21053,29177,50230
Faeroe Islands,,2018,21434,29521,50955
Faeroe Islands,,2019,21822,29859,51681
Faeroe Islands,,2020,22223,30192,52415
Faeroe Islands,,2021,22522,30367,52889
Fiji,FJI,1960,119270,282571,401841
Fiji,FJI,1961,125388,289146,414534
Fiji,FJI,1962,131828,295867,427695
Fiji,FJI,1963,138608,302777,441385
Fiji,FJI,1964,145628,309586,455214
Fiji,FJI,1965,152813,316197,469010
Fiji,FJI,1966,160046,322312,482358
Fiji,FJI,1967,166216,328416,494632
Fiji,FJI,1968,171967,334012,505979
Fiji,FJI,1969,177682,339270,516952
Fiji,FJI,1970,183395,344239,527634
Fiji,FJI,1971,189091,348909,538000
Fiji,FJI,1972,194719,353199,547918
Fiji,FJI,1973,200218,357026,557244
Fiji,FJI,1974,205701,360595,566296
Fiji,FJI,1975,211441,364363,575804
Fiji,FJI,1976,217743,368864,586607
Fiji,FJI,1977,223649,375640,599289
Fiji,FJI,1978,229914,383697,613611
Fiji,FJI,1979,236570,392289,628859
Fiji,FJI,1980,243452,401130,644582
Fiji,FJI,1981,250504,410126,660630
Fiji,FJI,1982,257721,419246,676967
Fiji,FJI,1983,265098,428495,693593
Fiji,FJI,1984,272656,437905,710561
Fiji,FJI,1985,280240,447221,727461
Fiji,FJI,1986,287223,455435,742658
Fiji,FJI,1987,296832,457946,754778
Fiji,FJI,1988,306398,457972,764370
Fiji,FJI,1989,315611,457093,772704
Fiji,FJI,1990,324745,455685,780430
Fiji,FJI,1991,332620,452212,784832
Fiji,FJI,1992,339577,447282,786859
Fiji,FJI,1993,346718,442480,789198
Fiji,FJI,1994,353592,437211,790803
Fiji,FJI,1995,360440,431806,792246
Fiji,FJI,1996,368654,427884,796538
Fiji,FJI,1997,375993,428579,804572
Fiji,FJI,1998,383556,430391,813947
Fiji,FJI,1999,391249,432173,823422
Fiji,FJI,2000,398838,433671,832509
Fiji,FJI,2001,406358,434962,841320
Fiji,FJI,2002,413829,436062,849891
Fiji,FJI,2003,421300,437006,858306
Fiji,FJI,2004,428832,437862,866694
Fiji,FJI,2005,436333,438590,874923
Fiji,FJI,2006,443873,439210,883083
Fiji,FJI,2007,451176,439472,890648
Fiji,FJI,2008,458642,438089,896731
Fiji,FJI,2009,465636,435747,901383
Fiji,FJI,2010,472236,432933,905169
Fiji,FJI,2011,478549,429806,908355
Fiji,FJI,2012,484647,426412,911059
Fiji,FJI,2013,490579,422874,913453
Fiji,FJI,2014,496380,419180,915560
Fiji,FJI,2015,501947,415253,917200
Fiji,FJI,2016,507262,411109,918371
Fiji,FJI,2017,512280,406739,919019
Fiji,FJI,2018,516917,402079,918996
Fiji,FJI,2019,521229,397236,918465
Fiji,FJI,2020,526914,393508,920422
Fiji,FJI,2021,533870,390740,924610
Finland,FIN,1960,2449145,1980489,4429634
Finland,FIN,1961,2512483,1948522,4461005
Finland,FIN,1962,2567399,1924044,4491443
Finland,FIN,1963,2623429,1899880,4523309
Finland,FIN,1964,2675999,1872544,4548543
Finland,FIN,1965,2722631,1841101,4563732
Finland,FIN,1966,2770510,1810359,4580869
Finland,FIN,1967,2823091,1782653,4605744
Finland,FIN,1968,2873315,1753154,4626469
Finland,FIN,1969,2908731,1715054,4623785
Finland,FIN,1970,2934402,1671905,4606307
Finland,FIN,1971,2975881,1636243,4612124
Finland,FIN,1972,3032758,1606899,4639657
Finland,FIN,1973,3088806,1577275,4666081
Finland,FIN,1974,3143576,1546998,4690574
Finland,FIN,1975,3195817,1515623,4711440
Finland,FIN,1976,3243412,1482252,4725664
Finland,FIN,1977,3289888,1449014,4738902
Finland,FIN,1978,3336370,1416158,4752528
Finland,FIN,1979,3381500,1383190,4764690
Finland,FIN,1980,3428217,1351318,4779535
Finland,FIN,1981,3481318,1318646,4799964
Finland,FIN,1982,3541666,1285267,4826933
Finland,FIN,1983,3603091,1252696,4855787
Finland,FIN,1984,3662085,1219718,4881803
Finland,FIN,1985,3716264,1185942,4902206
Finland,FIN,1986,3765683,1152471,4918154
Finland,FIN,1987,3812087,1120036,4932123
Finland,FIN,1988,3858255,1088226,4946481
Finland,FIN,1989,3906513,1057858,4964371
Finland,FIN,1990,3957581,1028850,4986431
Finland,FIN,1991,4003120,1010620,5013740
Finland,FIN,1992,4040047,1001945,5041992
Finland,FIN,1993,4073879,992568,5066447
Finland,FIN,1994,4105674,982659,5088333
Finland,FIN,1995,4135420,972370,5107790
Finland,FIN,1996,4162332,962241,5124573
Finland,FIN,1997,4187218,952617,5139835
Finland,FIN,1998,4210769,942729,5153498
Finland,FIN,1999,4232899,932575,5165474
Finland,FIN,2000,4253964,922245,5176209
Finland,FIN,2001,4273258,914750,5188008
Finland,FIN,2002,4290649,909949,5200598
Finland,FIN,2003,4307931,905083,5213014
Finland,FIN,2004,4327463,900709,5228172
Finland,FIN,2005,4349276,896820,5246096
Finland,FIN,2006,4372951,893317,5266268
Finland,FIN,2007,4398523,890197,5288720
Finland,FIN,2008,4426008,887391,5313399
Finland,FIN,2009,4454167,884704,5338871
Finland,FIN,2010,4492880,870472,5363352
Finland,FIN,2011,4543014,845258,5388272
Finland,FIN,2012,4593267,820704,5413971
Finland,FIN,2013,4629925,809047,5438972
Finland,FIN,2014,4651843,809669,5461512
Finland,FIN,2015,4669930,809601,5479531
Finland,FIN,2016,4686120,809183,5495303
Finland,FIN,2017,4699884,808330,5508214
Finland,FIN,2018,4709266,806259,5515525
Finland,FIN,2019,4717991,803615,5521606
Finland,FIN,2020,4728699,800844,5529543
Finland,FIN,2021,4742889,798128,5541017
France,FRA,1960,28866975,17782952,46649927
France,FRA,1961,29526489,17635152,47161641
France,FRA,1962,30271423,17408368,47679791
France,FRA,1963,31179854,17010084,48189938
France,FRA,1964,32114729,16619268,48733997
France,FRA,1965,33054437,16228319,49282756
France,FRA,1966,33987676,15829365,49817041
France,FRA,1967,34910161,15423851,50334012
France,FRA,1968,35692859,15124161,50817020
France,FRA,1969,36223125,15049558,51272683
France,FRA,1970,36752571,14971545,51724116
France,FRA,1971,37291038,14894184,52185222
France,FRA,1972,37825586,14812302,52637888
France,FRA,1973,38334453,14719207,53053660
France,FRA,1974,38806179,14609071,53415250
France,FRA,1975,39172735,14542998,53715733
France,FRA,1976,39393968,14572590,53966558
France,FRA,1977,39618922,14603066,54221988
France,FRA,1978,39851203,14634992,54486195
France,FRA,1979,40085640,14667935,54753575
France,FRA,1980,40343633,14708949,55052582
France,FRA,1981,40615768,14755276,55371044
France,FRA,1982,40893397,14800709,55694106
France,FRA,1983,41154602,14838054,55992656
France,FRA,1984,41404847,14870854,56275701
France,FRA,1985,41663212,14905983,56569195
France,FRA,1986,41923864,14941329,56865193
France,FRA,1987,42190286,14978123,57168409
France,FRA,1988,42457921,15014730,57472651
France,FRA,1989,42718166,15048116,57766282
France,FRA,1990,42985584,15059117,58044701
France,FRA,1991,43466704,15090873,58557577
France,FRA,1992,43784946,15064997,58849943
France,FRA,1993,44076650,15029516,59106166
France,FRA,1994,44343217,14984368,59327585
France,FRA,1995,44605346,14938313,59543659
France,FRA,1996,44866400,14890133,59756533
France,FRA,1997,45127383,14842561,59969944
France,FRA,1998,45395596,14797194,60192790
France,FRA,1999,45749812,14754608,60504420
France,FRA,2000,46221663,14699721,60921384
France,FRA,2001,46717151,14650237,61367388
France,FRA,2002,47215240,14600994,61816234
France,FRA,2003,47708761,14548209,62256970
France,FRA,2004,48218178,14498128,62716306
France,FRA,2005,48737209,14451186,63188395
France,FRA,2006,49233640,14394621,63628261
France,FRA,2007,49694312,14327425,64021737
France,FRA,2008,50131182,14248514,64379696
France,FRA,2009,50550197,14160682,64710879
France,FRA,2010,50963811,14066764,65030575
France,FRA,2011,51375729,13969504,65345233
France,FRA,2012,51793062,13869178,65662240
France,FRA,2013,52230911,13771378,66002289
France,FRA,2014,52647802,13664265,66312067
France,FRA,2015,53009026,13539246,66548272
France,FRA,2016,53323902,13400202,66724104
France,FRA,2017,53654868,13263152,66918020
France,FRA,2018,54024861,13133487,67158348
France,FRA,2019,54388182,12999819,67388001
France,FRA,2020,54715704,12855403,67571107
France,FRA,2021,55041156,12708476,67749632
French Polynesia,PYF,1960,35876,48975,84851
French Polynesia,PYF,1961,37565,49356,86921
French Polynesia,PYF,1962,39394,49814,89208
French Polynesia,PYF,1963,41741,50222,91963
French Polynesia,PYF,1964,44534,50658,95192
French Polynesia,PYF,1965,47539,51135,98674
French Polynesia,PYF,1966,50709,51572,102281
French Polynesia,PYF,1967,54035,51960,105995
French Polynesia,PYF,1968,57530,52302,109832
French Polynesia,PYF,1969,61195,52608,113803
French Polynesia,PYF,1970,65031,52860,117891
French Polynesia,PYF,1971,68628,53480,122108
French Polynesia,PYF,1972,71724,54733,126457
French Polynesia,PYF,1973,74906,55977,130883
French Polynesia,PYF,1974,78153,57196,135349
French Polynesia,PYF,1975,81456,58377,139833
French Polynesia,PYF,1976,84824,59532,144356
French Polynesia,PYF,1977,88169,60838,149007
French Polynesia,PYF,1978,90886,62859,153745
French Polynesia,PYF,1979,93646,64917,158563
French Polynesia,PYF,1980,96524,67067,163591
French Polynesia,PYF,1981,99558,69334,168892
French Polynesia,PYF,1982,102674,71669,174343
French Polynesia,PYF,1983,105341,73701,179042
French Polynesia,PYF,1984,107585,75561,183146
French Polynesia,PYF,1985,109986,77592,187578
French Polynesia,PYF,1986,112487,79709,192196
French Polynesia,PYF,1987,115001,81855,196856
French Polynesia,PYF,1988,117635,84105,201740
French Polynesia,PYF,1989,120005,86566,206571
French Polynesia,PYF,1990,122119,88970,211089
French Polynesia,PYF,1991,124117,91327,215444
French Polynesia,PYF,1992,125990,93631,219621
French Polynesia,PYF,1993,127794,95920,223714
French Polynesia,PYF,1994,129508,98174,227682
French Polynesia,PYF,1995,131084,100362,231446
French Polynesia,PYF,1996,132630,102559,235189
French Polynesia,PYF,1997,134541,104495,239036
French Polynesia,PYF,1998,136512,106370,242882
French Polynesia,PYF,1999,138531,108290,246821
French Polynesia,PYF,2000,140637,110290,250927
French Polynesia,PYF,2001,142743,112306,255049
French Polynesia,PYF,2002,144826,114311,259137
French Polynesia,PYF,2003,148014,115159,263173
French Polynesia,PYF,2004,151814,115318,267132
French Polynesia,PYF,2005,155635,115425,271060
French Polynesia,PYF,2006,159448,115453,274901
French Polynesia,PYF,2007,162971,115207,278178
French Polynesia,PYF,2008,165995,114563,280558
French Polynesia,PYF,2009,168642,113641,282283
French Polynesia,PYF,2010,171172,112616,283788
French Polynesia,PYF,2011,173695,111570,285265
French Polynesia,PYF,2012,176132,110452,286584
French Polynesia,PYF,2013,177379,110653,288032
French Polynesia,PYF,2014,178657,111216,289873
French Polynesia,PYF,2015,179983,111804,291787
French Polynesia,PYF,2016,181215,112326,293541
French Polynesia,PYF,2017,182541,112909,295450
French Polynesia,PYF,2018,184022,113584,297606
French Polynesia,PYF,2019,185516,114201,299717
French Polynesia,PYF,2020,187115,114805,301920
French Polynesia,PYF,2021,188701,115331,304032
Gabon,GAB,1960,89311,424029,513340
Gabon,GAB,1961,95193,424136,519329
Gabon,GAB,1962,103016,422738,525754
Gabon,GAB,1963,111434,421158,532592
Gabon,GAB,1964,120479,419351,539830
Gabon,GAB,1965,130176,417359,547535
Gabon,GAB,1966,140588,415160,555748
Gabon,GAB,1967,151737,412699,564436
Gabon,GAB,1968,163668,409943,573611
Gabon,GAB,1969,176774,407854,584628
Gabon,GAB,1970,191101,406091,597192
Gabon,GAB,1971,207796,401897,609693
Gabon,GAB,1972,225462,396827,622289
Gabon,GAB,1973,244141,391147,635288
Gabon,GAB,1974,263988,384934,648922
Gabon,GAB,1975,285044,378296,663340
Gabon,GAB,1976,307399,371261,678660
Gabon,GAB,1977,331016,363915,694931
Gabon,GAB,1978,355961,356174,712135
Gabon,GAB,1979,382158,348030,730188
Gabon,GAB,1980,409611,339467,749078
Gabon,GAB,1981,438275,330629,768904
Gabon,GAB,1982,460897,328688,789585
Gabon,GAB,1983,484469,326629,811098
Gabon,GAB,1984,509018,324399,833417
Gabon,GAB,1985,534462,322020,856482
Gabon,GAB,1986,560873,319467,880340
Gabon,GAB,1987,588260,316756,905016
Gabon,GAB,1988,617940,312524,930464
Gabon,GAB,1989,648437,308072,956509
Gabon,GAB,1990,679695,303333,983028
Gabon,GAB,1991,711663,298332,1009995
Gabon,GAB,1992,744357,293089,1037446
Gabon,GAB,1993,777724,287666,1065390
Gabon,GAB,1994,808408,285203,1093611
Gabon,GAB,1995,839195,282769,1121964
Gabon,GAB,1996,870476,280125,1150601
Gabon,GAB,1997,902434,277372,1179806
Gabon,GAB,1998,935273,274559,1209832
Gabon,GAB,1999,969061,271703,1240764
Gabon,GAB,2000,1004078,268857,1272935
Gabon,GAB,2001,1040477,266113,1306590
Gabon,GAB,2002,1078294,263402,1341696
Gabon,GAB,2003,1117646,260752,1378398
Gabon,GAB,2004,1158884,258226,1417110
Gabon,GAB,2005,1202441,255912,1458353
Gabon,GAB,2006,1248711,253823,1502534
Gabon,GAB,2007,1297812,251962,1549774
Gabon,GAB,2008,1349725,250253,1599978
Gabon,GAB,2009,1404767,248775,1653542
Gabon,GAB,2010,1463559,247546,1711105
Gabon,GAB,2011,1525981,246519,1772500
Gabon,GAB,2012,1591211,245494,1836705
Gabon,GAB,2013,1657904,244322,1902226
Gabon,GAB,2014,1723968,242887,1966855
Gabon,GAB,2015,1787489,241028,2028517
Gabon,GAB,2016,1847523,238683,2086206
Gabon,GAB,2017,1904278,235937,2140215
Gabon,GAB,2018,1959001,233011,2192012
Gabon,GAB,2019,2012698,230087,2242785
Gabon,GAB,2020,2065425,227148,2292573
Gabon,GAB,2021,2116964,224215,2341179
Gambia,GMB,1960,48473,351176,399649
Gambia,GMB,1961,50656,360145,410801
Gambia,GMB,1962,52937,369373,422310
Gambia,GMB,1963,55843,378330,434173
Gambia,GMB,1964,61051,385324,446375
Gambia,GMB,1965,66693,392215,458908
Gambia,GMB,1966,72806,398947,471753
Gambia,GMB,1967,79460,405672,485132
Gambia,GMB,1968,86718,412433,499151
Gambia,GMB,1969,94570,419116,513686
Gambia,GMB,1970,103081,425650,528731
Gambia,GMB,1971,112293,432024,544317
Gambia,GMB,1972,122279,438274,560553
Gambia,GMB,1973,132482,445006,577488
Gambia,GMB,1974,140844,454060,594904
Gambia,GMB,1975,149709,463200,612909
Gambia,GMB,1976,159193,472701,631894
Gambia,GMB,1977,169333,482601,651934
Gambia,GMB,1978,180169,492805,672974
Gambia,GMB,1979,191759,503396,695155
Gambia,GMB,1980,204179,514407,718586
Gambia,GMB,1981,217327,525519,742846
Gambia,GMB,1982,231350,536922,768272
Gambia,GMB,1983,246688,548875,795563
Gambia,GMB,1984,263993,560805,824798
Gambia,GMB,1985,282629,573329,855958
Gambia,GMB,1986,302689,586291,888980
Gambia,GMB,1987,324238,599676,923914
Gambia,GMB,1988,347391,613446,960837
Gambia,GMB,1989,372160,627572,999732
Gambia,GMB,1990,398681,641935,1040616
Gambia,GMB,1991,427022,656514,1083536
Gambia,GMB,1992,456722,670430,1127152
Gambia,GMB,1993,485853,682456,1168309
Gambia,GMB,1994,512162,693720,1205882
Gambia,GMB,1995,538623,703532,1242155
Gambia,GMB,1996,566091,712979,1279070
Gambia,GMB,1997,594692,722310,1317002
Gambia,GMB,1998,624620,731569,1356189
Gambia,GMB,1999,655810,740689,1396499
Gambia,GMB,2000,688121,749418,1437539
Gambia,GMB,2001,721601,757848,1479449
Gambia,GMB,2002,756286,765937,1522223
Gambia,GMB,2003,791821,774436,1566257
Gambia,GMB,2004,826878,785347,1612225
Gambia,GMB,2005,863723,796645,1660368
Gambia,GMB,2006,902725,808569,1711294
Gambia,GMB,2007,943877,821006,1764883
Gambia,GMB,2008,986934,833608,1820542
Gambia,GMB,2009,1031782,846337,1878119
Gambia,GMB,2010,1078326,858949,1937275
Gambia,GMB,2011,1126672,871540,1998212
Gambia,GMB,2012,1176942,884072,2061014
Gambia,GMB,2013,1228599,896270,2124869
Gambia,GMB,2014,1281189,907830,2189019
Gambia,GMB,2015,1334486,918647,2253133
Gambia,GMB,2016,1388423,928783,2317206
Gambia,GMB,2017,1442972,938210,2381182
Gambia,GMB,2018,1498000,946916,2444916
Gambia,GMB,2019,1553776,955107,2508883
Gambia,GMB,2020,1610858,963137,2573995
Gambia,GMB,2021,1669008,970908,2639916
Georgia,GEO,1960,1570123,2075477,3645600
Georgia,GEO,1961,1613251,2090349,3703600
Georgia,GEO,1962,1656450,2103850,3760300
Georgia,GEO,1963,1699844,2116256,3816100
Georgia,GEO,1964,1743144,2127156,3870300
Georgia,GEO,1965,1785661,2135939,3921600
Georgia,GEO,1966,1825872,2140828,3966700
Georgia,GEO,1967,1863779,2142021,4005800
Georgia,GEO,1968,1900892,2141408,4042300
Georgia,GEO,1969,1939040,2141260,4080300
Georgia,GEO,1970,1977799,2142101,4119900
Georgia,GEO,1971,2017973,2145027,4163000
Georgia,GEO,1972,2058158,2147142,4205300
Georgia,GEO,1973,2096177,2146323,4242500
Georgia,GEO,1974,2134443,2145057,4279500
Georgia,GEO,1975,2170431,2140769,4311200
Georgia,GEO,1976,2206460,2135940,4342400
Georgia,GEO,1977,2241969,2130131,4372100
Georgia,GEO,1978,2275678,2122022,4397700
Georgia,GEO,1979,2310615,2119585,4430200
Georgia,GEO,1980,2345408,2122292,4467700
Georgia,GEO,1981,2379998,2124502,4504500
Georgia,GEO,1982,2415679,2127121,4542800
Georgia,GEO,1983,2452585,2130315,4582900
Georgia,GEO,1984,2489286,2132914,4622200
Georgia,GEO,1985,2527012,2135888,4662900
Georgia,GEO,1986,2565458,2139042,4704500
Georgia,GEO,1987,2602758,2140742,4743500
Georgia,GEO,1988,2644850,2145850,4790700
Georgia,GEO,1989,2655120,2148180,4803300
Georgia,GEO,1990,2642925,2159075,4802000
Georgia,GEO,1991,2650025,2185875,4835900
Georgia,GEO,1992,2658933,2214567,4873500
Georgia,GEO,1993,2667710,2243390,4911100
Georgia,GEO,1994,2615350,2220726,4836076
Georgia,GEO,1995,2507764,2149958,4657722
Georgia,GEO,1996,2407551,2084148,4491699
Georgia,GEO,1997,2321114,2028799,4349913
Georgia,GEO,1998,2254204,1989403,4243607
Georgia,GEO,1999,2198282,1958910,4157192
Georgia,GEO,2000,2146120,1931011,4077131
Georgia,GEO,2001,2103451,1910922,4014373
Georgia,GEO,2002,2086373,1892142,3978515
Georgia,GEO,2003,2087702,1864034,3951736
Georgia,GEO,2004,2090052,1837288,3927340
Georgia,GEO,2005,2091919,1810550,3902469
Georgia,GEO,2006,2095077,1785270,3880347
Georgia,GEO,2007,2099115,1761043,3860158
Georgia,GEO,2008,2107603,1740846,3848449
Georgia,GEO,2009,2103652,1710767,3814419
Georgia,GEO,2010,2102941,1683754,3786695
Georgia,GEO,2011,2100564,1655877,3756441
Georgia,GEO,2012,2099468,1629406,3728874
Georgia,GEO,2013,2107360,1610308,3717668
Georgia,GEO,2014,2122558,1596856,3719414
Georgia,GEO,2015,2140097,1585179,3725276
Georgia,GEO,2016,2155877,1571628,3727505
Georgia,GEO,2017,2170854,1557150,3728004
Georgia,GEO,2018,2184950,1541599,3726549
Georgia,GEO,2019,2196346,1523815,3720161
Georgia,GEO,2020,2213266,1509450,3722716
Georgia,GEO,2021,2220419,1488191,3708610
Germany,DEU,1960,51978188,20836712,72814900
Germany,DEU,1961,52609561,20768072,73377633
Germany,DEU,1962,53122383,20903400,74025783
Germany,DEU,1963,53664331,21050022,74714353
Germany,DEU,1964,54147106,21171232,75318338
Germany,DEU,1965,54659677,21304018,75963695
Germany,DEU,1966,55166778,21433532,76600310
Germany,DEU,1967,55468832,21482504,76951336
Germany,DEU,1968,55765529,21528784,77294313
Germany,DEU,1969,56259360,21650322,77909682
Germany,DEU,1970,56496072,21673216,78169288
Germany,DEU,1971,56645245,21667596,78312841
Germany,DEU,1972,56961784,21726668,78688452
Germany,DEU,1973,57186457,21750208,78936665
Germany,DEU,1974,57253758,21713676,78967434
Germany,DEU,1975,57085531,21588024,78673555
Germany,DEU,1976,56885943,21451008,78336951
Germany,DEU,1977,56801863,21357952,78159815
Germany,DEU,1978,56796181,21295640,78091821
Germany,DEU,1979,56865826,21260524,78126350
Germany,DEU,1980,57028530,21260046,78288576
Germany,DEU,1981,57229147,21178760,78407907
Germany,DEU,1982,57267174,21066192,78333366
Germany,DEU,1983,57114118,21014164,78128282
Germany,DEU,1984,56792461,21066224,77858685
Germany,DEU,1985,56485448,21199424,77684872
Germany,DEU,1986,56438249,21282188,77720437
Germany,DEU,1987,56695484,21144436,77839920
Germany,DEU,1988,57044790,21099828,78144618
Germany,DEU,1989,57469536,21281748,78751284
Germany,DEU,1990,58079842,21353188,79433030
Germany,DEU,1991,58625381,21388516,80013897
Germany,DEU,1992,59146205,21478392,80624597
Germany,DEU,1993,59647492,21508872,81156364
Germany,DEU,1994,60028206,21410142,81438348
Germany,DEU,1995,60378049,21300002,81678051
Germany,DEU,1996,60725922,21188908,81914830
Germany,DEU,1997,60986289,21048482,82034771
Germany,DEU,1998,61167004,20880192,82047196
Germany,DEU,1999,61376500,20723744,82100244
Germany,DEU,2000,61629857,20581652,82211509
Germany,DEU,2001,61902439,20447486,82349925
Germany,DEU,2002,62174878,20313616,82488494
Germany,DEU,2003,62376854,20157322,82534176
Germany,DEU,2004,62529997,19986264,82516261
Germany,DEU,2005,62660267,19809156,82469423
Germany,DEU,2006,62753557,19622894,82376451
Germany,DEU,2007,62833410,19432962,82266372
Germany,DEU,2008,62875807,19234290,82110097
Germany,DEU,2009,62877220,19025088,81902308
Germany,DEU,2010,62940432,18836498,81776930
Germany,DEU,2011,61940177,18334806,80274983
Germany,DEU,2012,62064608,18361216,80425824
Germany,DEU,2013,62242278,18403328,80645606
Germany,DEU,2014,62510392,18472108,80982500
Germany,DEU,2015,63062064,18624548,81686612
Germany,DEU,2016,63592936,18755732,82348668
Germany,DEU,2017,63861626,18795376,82657002
Germany,DEU,2018,64096118,18809664,82905782
Germany,DEU,2019,64294010,18798952,83092962
Germany,DEU,2020,64410589,18750282,83160871
Germany,DEU,2021,64513567,18682512,83196079
Ghana,GHA,1960,1607064,5304446,6911510
Ghana,GHA,1961,1691736,5417293,7109029
Ghana,GHA,1962,1773116,5508076,7281192
Ghana,GHA,1963,1858221,5600022,7458243
Ghana,GHA,1964,1947333,5692863,7640196
Ghana,GHA,1965,2040453,5787273,7827726
Ghana,GHA,1966,2137720,5881938,8019658
Ghana,GHA,1967,2239212,5976874,8216086
Ghana,GHA,1968,2345297,6072855,8418152
Ghana,GHA,1969,2457179,6172676,8629855
Ghana,GHA,1970,2566228,6295667,8861895
Ghana,GHA,1971,2657424,6451454,9108878
Ghana,GHA,1972,2752841,6613111,9365952
Ghana,GHA,1973,2853574,6783623,9637197
Ghana,GHA,1974,2958732,6960247,9918979
Ghana,GHA,1975,3067957,7141891,10209848
Ghana,GHA,1976,3181076,7327930,10509006
Ghana,GHA,1977,3300910,7524586,10825496
Ghana,GHA,1978,3428674,7734556,11163230
Ghana,GHA,1979,3562720,7952955,11515675
Ghana,GHA,1980,3697567,8167679,11865246
Ghana,GHA,1981,3833404,8379556,12212960
Ghana,GHA,1982,3978614,8606362,12584976
Ghana,GHA,1983,4134407,8849724,12984131
Ghana,GHA,1984,4297482,9045005,13342487
Ghana,GHA,1985,4490779,9160664,13651443
Ghana,GHA,1986,4693228,9278454,13971682
Ghana,GHA,1987,4907599,9403191,14310790
Ghana,GHA,1988,5135674,9536003,14671677
Ghana,GHA,1989,5376584,9675863,15052447
Ghana,GHA,1990,5629035,9817947,15446982
Ghana,GHA,1991,5889018,9954453,15843471
Ghana,GHA,1992,6156359,10085189,16241548
Ghana,GHA,1993,6431766,10211867,16643633
Ghana,GHA,1994,6712392,10328462,17040854
Ghana,GHA,1995,6999964,10438910,17438874
Ghana,GHA,1996,7297486,10546524,17844010
Ghana,GHA,1997,7609369,10658671,18268040
Ghana,GHA,1998,7938405,10776303,18714708
Ghana,GHA,1999,8281305,10895486,19176791
Ghana,GHA,2000,8638858,11026644,19665502
Ghana,GHA,2001,9007429,11188148,20195577
Ghana,GHA,2002,9398332,11359994,20758326
Ghana,GHA,2003,9801125,11528389,21329514
Ghana,GHA,2004,10214975,11691469,21906444
Ghana,GHA,2005,10642858,11854093,22496951
Ghana,GHA,2006,11084549,12014037,23098586
Ghana,GHA,2007,11538602,12169718,23708320
Ghana,GHA,2008,12005167,12320920,24326087
Ghana,GHA,2009,12483116,12467646,24950762
Ghana,GHA,2010,12969707,12605012,25574719
Ghana,GHA,2011,13468281,12737660,26205941
Ghana,GHA,2012,13986163,12872599,26858762
Ghana,GHA,2013,14519202,13006395,27525597
Ghana,GHA,2014,15062212,13134146,28196358
Ghana,GHA,2015,15615136,13255803,28870939
Ghana,GHA,2016,16180685,13373618,29554303
Ghana,GHA,2017,16745249,13477013,30222262
Ghana,GHA,2018,17306081,13564560,30870641
Ghana,GHA,2019,17875345,13646945,31522290
Ghana,GHA,2020,18455138,13725263,32180401
Ghana,GHA,2021,19038233,13794798,32833031
Gibraltar,GIB,1960,21822,0,21822
Gibraltar,GIB,1961,21907,0,21907
Gibraltar,GIB,1962,22249,0,22249
Gibraltar,GIB,1963,22796,0,22796
Gibraltar,GIB,1964,23347,0,23347
Gibraltar,GIB,1965,23910,0,23910
Gibraltar,GIB,1966,24477,0,24477
Gibraltar,GIB,1967,25047,0,25047
Gibraltar,GIB,1968,25610,0,25610
Gibraltar,GIB,1969,26162,0,26162
Gibraltar,GIB,1970,26685,0,26685
Gibraltar,GIB,1971,27069,0,27069
Gibraltar,GIB,1972,27323,0,27323
Gibraltar,GIB,1973,27558,0,27558
Gibraltar,GIB,1974,27779,0,27779
Gibraltar,GIB,1975,27973,0,27973
Gibraltar,GIB,1976,28162,0,28162
Gibraltar,GIB,1977,28337,0,28337
Gibraltar,GIB,1978,28485,0,28485
Gibraltar,GIB,1979,28618,0,28618
Gibraltar,GIB,1980,28734,0,28734
Gibraltar,GIB,1981,28819,0,28819
Gibraltar,GIB,1982,28863,0,28863
Gibraltar,GIB,1983,28855,0,28855
Gibraltar,GIB,1984,28788,0,28788
Gibraltar,GIB,1985,28674,0,28674
Gibraltar,GIB,1986,28506,0,28506
Gibraltar,GIB,1987,28272,0,28272
Gibraltar,GIB,1988,28000,0,28000
Gibraltar,GIB,1989,27688,0,27688
Gibraltar,GIB,1990,27317,0,27317
Gibraltar,GIB,1991,26988,0,26988
Gibraltar,GIB,1992,26945,0,26945
Gibraltar,GIB,1993,27118,0,27118
Gibraltar,GIB,1994,27282,0,27282
Gibraltar,GIB,1995,27412,0,27412
Gibraltar,GIB,1996,27491,0,27491
Gibraltar,GIB,1997,27564,0,27564
Gibraltar,GIB,1998,27636,0,27636
Gibraltar,GIB,1999,27695,0,27695
Gibraltar,GIB,2000,27741,0,27741
Gibraltar,GIB,2001,27721,0,27721
Gibraltar,GIB,2002,27892,0,27892
Gibraltar,GIB,2003,28301,0,28301
Gibraltar,GIB,2004,28716,0,28716
Gibraltar,GIB,2005,29155,0,29155
Gibraltar,GIB,2006,29587,0,29587
Gibraltar,GIB,2007,29996,0,29996
Gibraltar,GIB,2008,30398,0,30398
Gibraltar,GIB,2009,30819,0,30819
Gibraltar,GIB,2010,31262,0,31262
Gibraltar,GIB,2011,31701,0,31701
Gibraltar,GIB,2012,32160,0,32160
Gibraltar,GIB,2013,32411,0,32411
Gibraltar,GIB,2014,32452,0,32452
Gibraltar,GIB,2015,32520,0,32520
Gibraltar,GIB,2016,32565,0,32565
Gibraltar,GIB,2017,32602,0,32602
Gibraltar,GIB,2018,32648,0,32648
Gibraltar,GIB,2019,32685,0,32685
Gibraltar,GIB,2020,32709,0,32709
Gibraltar,GIB,2021,32669,0,32669
Greece,GRC,1960,4660434,3671291,8331725
Greece,GRC,1961,4740951,3657099,8398050
Greece,GRC,1962,4844217,3604016,8448233
Greece,GRC,1963,4937007,3542618,8479625
Greece,GRC,1964,5029578,3480851,8510429
Greece,GRC,1965,5127549,3422784,8550333
Greece,GRC,1966,5239942,3373709,8613651
Greece,GRC,1967,5357301,3326787,8684088
Greece,GRC,1968,5466737,3274028,8740765
Greece,GRC,1969,5560616,3212148,8772764
Greece,GRC,1970,5646740,3146066,8792806
Greece,GRC,1971,5735846,3095190,8831036
Greece,GRC,1972,5817963,3070665,8888628
Greece,GRC,1973,5888911,3040175,8929086
Greece,GRC,1974,5955084,3006938,8962022
Greece,GRC,1975,6055755,2990786,9046541
Greece,GRC,1976,6195478,2992672,9188150
Greece,GRC,1977,6321574,2986905,9308479
Greece,GRC,1978,6449432,2980527,9429959
Greece,GRC,1979,6575885,2972373,9548258
Greece,GRC,1980,6686402,2956103,9642505
Greece,GRC,1981,6785832,2943518,9729350
Greece,GRC,1982,6846785,2942728,9789513
Greece,GRC,1983,6905833,2940794,9846627
Greece,GRC,1984,6959420,2936381,9895801
Greece,GRC,1985,7005470,2928830,9934300
Greece,GRC,1986,7047717,2919496,9967213
Greece,GRC,1987,7090422,2910173,10000595
Greece,GRC,1988,7135291,2901692,10036983
Greece,GRC,1989,7191693,2897805,10089498
Greece,GRC,1990,7287341,2909451,10196792
Greece,GRC,1991,7392680,2927247,10319927
Greece,GRC,1992,7462054,2937007,10399061
Greece,GRC,1993,7518737,2941678,10460415
Greece,GRC,1994,7569094,2943828,10512922
Greece,GRC,1995,7617319,2944834,10562153
Greece,GRC,1996,7663691,2945109,10608800
Greece,GRC,1997,7714274,2946985,10661259
Greece,GRC,1998,7770011,2950498,10720509
Greece,GRC,1999,7812670,2949028,10761698
Greece,GRC,2000,7857551,2948257,10805808
Greece,GRC,2001,7919906,2942226,10862132
Greece,GRC,2002,7991509,2910513,10902022
Greece,GRC,2003,8052786,2875284,10928070
Greece,GRC,2004,8114802,2840339,10955141
Greece,GRC,2005,8180275,2807039,10987314
Greece,GRC,2006,8246206,2774156,11020362
Greece,GRC,2007,8308341,2740132,11048473
Greece,GRC,2008,8371303,2706538,11077841
Greece,GRC,2009,8433780,2673237,11107017
Greece,GRC,2010,8484693,2636648,11121341
Greece,GRC,2011,8511794,2593105,11104899
Greece,GRC,2012,8505100,2539911,11045011
Greece,GRC,2013,8482139,2483072,10965211
Greece,GRC,2014,8463623,2428790,10892413
Greece,GRC,2015,8445266,2375617,10820883
Greece,GRC,2016,8446960,2329011,10775971
Greece,GRC,2017,8466513,2288166,10754679
Greece,GRC,2018,8485202,2247680,10732882
Greece,GRC,2019,8511650,2209932,10721582
Greece,GRC,2020,8528388,2170211,10698599
Greece,GRC,2021,8517020,2124201,10641221
Greenland,GRL,1960,19024,13476,32500
Greenland,GRL,1961,20155,13545,33700
Greenland,GRL,1962,21492,13508,35000
Greenland,GRL,1963,22926,13474,36400
Greenland,GRL,1964,24265,13335,37600
Greenland,GRL,1965,25892,13308,39200
Greenland,GRL,1966,27334,13166,40500
Greenland,GRL,1967,28849,13051,41900
Greenland,GRL,1968,30461,12939,43400
Greenland,GRL,1969,32095,12805,44900
Greenland,GRL,1970,33753,12647,46400
Greenland,GRL,1971,34660,12540,47200
Greenland,GRL,1972,35585,12715,48300
Greenland,GRL,1973,36218,12782,49000
Greenland,GRL,1974,36705,12795,49500
Greenland,GRL,1975,36897,12703,49600
Greenland,GRL,1976,37089,12611,49700
Greenland,GRL,1977,37033,12367,49400
Greenland,GRL,1978,37075,12125,49200
Greenland,GRL,1979,37567,12033,49600
Greenland,GRL,1980,38213,11987,50200
Greenland,GRL,1981,39013,11987,51000
Greenland,GRL,1982,39588,11912,51500
Greenland,GRL,1983,40240,11860,52100
Greenland,GRL,1984,40896,11804,52700
Greenland,GRL,1985,41475,11725,53200
Greenland,GRL,1986,41900,11600,53500
Greenland,GRL,1987,42559,11541,54100
Greenland,GRL,1988,43301,11499,54800
Greenland,GRL,1989,43886,11414,55300
Greenland,GRL,1990,44312,11288,55600
Greenland,GRL,1991,44418,11082,55500
Greenland,GRL,1992,44406,10894,55300
Greenland,GRL,1993,44438,10762,55200
Greenland,GRL,1994,44790,10710,55500
Greenland,GRL,1995,45143,10657,55800
Greenland,GRL,1996,45335,10565,55900
Greenland,GRL,1997,45487,10513,56000
Greenland,GRL,1998,45638,10462,56100
Greenland,GRL,1999,45708,10392,56100
Greenland,GRL,2000,45859,10341,56200
Greenland,GRL,2001,46122,10228,56350
Greenland,GRL,2002,46473,10136,56609
Greenland,GRL,2003,46739,10026,56765
Greenland,GRL,2004,46997,9914,56911
Greenland,GRL,2005,47175,9760,56935
Greenland,GRL,2006,47220,9554,56774
Greenland,GRL,2007,47213,9342,56555
Greenland,GRL,2008,47196,9132,56328
Greenland,GRL,2009,47360,8963,56323
Greenland,GRL,2010,48018,8887,56905
Greenland,GRL,2011,48217,8673,56890
Greenland,GRL,2012,48402,8408,56810
Greenland,GRL,2013,48322,8161,56483
Greenland,GRL,2014,48308,7987,56295
Greenland,GRL,2015,48298,7816,56114
Greenland,GRL,2016,48503,7683,56186
Greenland,GRL,2017,48629,7542,56171
Greenland,GRL,2018,48637,7386,56023
Greenland,GRL,2019,48945,7280,56225
Greenland,GRL,2020,49198,7169,56367
Greenland,GRL,2021,49575,7078,56653
Grenada,GRD,1960,28443,65329,93772
Grenada,GRD,1961,29022,66074,95096
Grenada,GRD,1962,29495,66557,96052
Grenada,GRD,1963,29932,66950,96882
Grenada,GRD,1964,30343,67270,97613
Grenada,GRD,1965,30719,67507,98226
Grenada,GRD,1966,31053,67639,98692
Grenada,GRD,1967,31332,67645,98977
Grenada,GRD,1968,31547,67509,99056
Grenada,GRD,1969,31712,67263,98975
Grenada,GRD,1970,31824,66970,98794
Grenada,GRD,1971,31808,66727,98535
Grenada,GRD,1972,31777,66448,98225
Grenada,GRD,1973,31736,66150,97886
Grenada,GRD,1974,31688,65840,97528
Grenada,GRD,1975,31638,65527,97165
Grenada,GRD,1976,31581,65200,96781
Grenada,GRD,1977,31501,64828,96329
Grenada,GRD,1978,31398,64413,95811
Grenada,GRD,1979,31278,63964,95242
Grenada,GRD,1980,31213,63625,94838
Grenada,GRD,1981,31402,63820,95222
Grenada,GRD,1982,31883,64651,96534
Grenada,GRD,1983,32475,65702,98177
Grenada,GRD,1984,33001,66617,99618
Grenada,GRD,1985,33368,67208,100576
Grenada,GRD,1986,33524,67369,100893
Grenada,GRD,1987,33476,67123,100599
Grenada,GRD,1988,33286,66591,99877
Grenada,GRD,1989,33118,66106,99224
Grenada,GRD,1990,33108,65939,99047
Grenada,GRD,1991,33422,66336,99758
Grenada,GRD,1992,34095,66945,101040
Grenada,GRD,1993,34723,67450,102173
Grenada,GRD,1994,35313,67861,103174
Grenada,GRD,1995,35869,68191,104060
Grenada,GRD,1996,36396,68450,104846
Grenada,GRD,1997,36899,68650,105549
Grenada,GRD,1998,37387,68813,106200
Grenada,GRD,1999,37869,68954,106823
Grenada,GRD,2000,38351,69081,107432
Grenada,GRD,2001,38770,69166,107936
Grenada,GRD,2002,38869,69362,108231
Grenada,GRD,2003,39045,69695,108740
Grenada,GRD,2004,39317,70199,109516
Grenada,GRD,2005,39576,70678,110254
Grenada,GRD,2006,39832,71156,110988
Grenada,GRD,2007,40090,71635,111725
Grenada,GRD,2008,40354,72124,112478
Grenada,GRD,2009,40624,72625,113249
Grenada,GRD,2010,40900,73139,114039
Grenada,GRD,2011,41208,73710,114918
Grenada,GRD,2012,41576,74336,115912
Grenada,GRD,2013,41979,74966,116945
Grenada,GRD,2014,42397,75575,117972
Grenada,GRD,2015,42829,76151,118980
Grenada,GRD,2016,43274,76692,119966
Grenada,GRD,2017,43730,77191,120921
Grenada,GRD,2018,44193,77645,121838
Grenada,GRD,2019,44667,78057,122724
Grenada,GRD,2020,45183,78480,123663
Grenada,GRD,2021,45724,78886,124610
Guam,GUM,1960,36293,36081,72374
Guam,GUM,1961,37845,36028,73873
Guam,GUM,1962,39451,35961,75412
Guam,GUM,1963,41113,35883,76996
Guam,GUM,1964,42829,35792,78621
Guam,GUM,1965,44580,35675,80255
Guam,GUM,1966,46357,35522,81879
Guam,GUM,1967,48151,35329,83480
Guam,GUM,1968,49954,35092,85046
Guam,GUM,1969,51733,34801,86534
Guam,GUM,1970,54675,33625,88300
Guam,GUM,1971,60777,29728,90505
Guam,GUM,1972,66826,25989,92815
Guam,GUM,1973,72629,22471,95100
Guam,GUM,1974,78108,19221,97329
Guam,GUM,1975,83195,16283,99478
Guam,GUM,1976,87910,13680,101590
Guam,GUM,1977,92254,11422,103676
Guam,GUM,1978,96234,9476,105710
Guam,GUM,1979,99961,7829,107790
Guam,GUM,1980,103396,6890,110286
Guam,GUM,1981,105851,7370,113221
Guam,GUM,1982,108310,7879,116189
Guam,GUM,1983,110657,8410,119067
Guam,GUM,1984,112918,8967,121885
Guam,GUM,1985,115124,9551,124675
Guam,GUM,1986,117294,10168,127462
Guam,GUM,1987,119441,10818,130259
Guam,GUM,1988,121573,11506,133079
Guam,GUM,1989,123543,12216,135759
Guam,GUM,1990,125537,12726,138263
Guam,GUM,1991,128158,12581,140739
Guam,GUM,1992,130746,12427,143173
Guam,GUM,1993,133273,12268,145541
Guam,GUM,1994,135744,12099,147843
Guam,GUM,1995,138169,11925,150094
Guam,GUM,1996,140517,11744,152261
Guam,GUM,1997,142775,11555,154330
Guam,GUM,1998,144995,11362,156357
Guam,GUM,1999,147222,11173,158395
Guam,GUM,2000,149181,11007,160188
Guam,GUM,2001,150594,10930,161524
Guam,GUM,2002,151727,10836,162563
Guam,GUM,2003,152659,10726,163385
Guam,GUM,2004,153400,10604,164004
Guam,GUM,2005,153957,10473,164430
Guam,GUM,2006,154345,10330,164675
Guam,GUM,2007,154584,10179,164763
Guam,GUM,2008,154703,10022,164725
Guam,GUM,2009,154718,9862,164580
Guam,GUM,2010,155174,9731,164905
Guam,GUM,2011,156021,9628,165649
Guam,GUM,2012,156869,9523,166392
Guam,GUM,2013,157639,9415,167054
Guam,GUM,2014,158243,9300,167543
Guam,GUM,2015,158796,9182,167978
Guam,GUM,2016,159284,9062,168346
Guam,GUM,2017,159668,8938,168606
Guam,GUM,2018,159873,8805,168678
Guam,GUM,2019,159955,8669,168624
Guam,GUM,2020,160665,8566,169231
Guam,GUM,2021,162033,8501,170534
Guatemala,GTM,1960,1284949,2843931,4128880
Guatemala,GTM,1961,1350747,2901164,4251911
Guatemala,GTM,1962,1419719,2958885,4378604
Guatemala,GTM,1963,1491664,3016780,4508444
Guatemala,GTM,1964,1563113,3077682,4640795
Guatemala,GTM,1965,1622969,3152015,4774984
Guatemala,GTM,1966,1684303,3226487,4910790
Guatemala,GTM,1967,1746816,3300619,5047435
Guatemala,GTM,1968,1810234,3373861,5184095
Guatemala,GTM,1969,1874378,3445722,5320100
Guatemala,GTM,1970,1939050,3516147,5455197
Guatemala,GTM,1971,2004473,3585090,5589563
Guatemala,GTM,1972,2070684,3653075,5723759
Guatemala,GTM,1973,2137989,3720477,5858466
Guatemala,GTM,1974,2206442,3787858,5994300
Guatemala,GTM,1975,2276190,3854961,6131151
Guatemala,GTM,1976,2347670,3922313,6269983
Guatemala,GTM,1977,2421551,3991116,6412667
Guatemala,GTM,1978,2498844,4063075,6561919
Guatemala,GTM,1979,2580838,4139744,6720582
Guatemala,GTM,1980,2668218,4222128,6890346
Guatemala,GTM,1981,2761086,4310100,7071186
Guatemala,GTM,1982,2859308,4403350,7262658
Guatemala,GTM,1983,2962273,4500312,7462585
Guatemala,GTM,1984,3069556,4600307,7669863
Guatemala,GTM,1985,3180971,4703063,7884034
Guatemala,GTM,1986,3296596,4808325,8104921
Guatemala,GTM,1987,3416470,4915976,8332446
Guatemala,GTM,1988,3540636,5025695,8566331
Guatemala,GTM,1989,3668666,5137329,8805995
Guatemala,GTM,1990,3800324,5249791,9050115
Guatemala,GTM,1991,3934691,5362123,9296814
Guatemala,GTM,1992,4071017,5473038,9544055
Guatemala,GTM,1993,4208693,5581926,9790619
Guatemala,GTM,1994,4348255,5689267,10037522
Guatemala,GTM,1995,4490594,5796192,10286786
Guatemala,GTM,1996,4635095,5901847,10536942
Guatemala,GTM,1997,4781726,6006636,10788362
Guatemala,GTM,1998,4933129,6113086,11046215
Guatemala,GTM,1999,5089420,6221658,11311078
Guatemala,GTM,2000,5253870,6335891,11589761
Guatemala,GTM,2001,5421506,6450059,11871565
Guatemala,GTM,2002,5588466,6559052,12147518
Guatemala,GTM,2003,5750534,6664800,12415334
Guatemala,GTM,2004,5911891,6770217,12682108
Guatemala,GTM,2005,6074432,6873860,12948292
Guatemala,GTM,2006,6238013,6975317,13213330
Guatemala,GTM,2007,6402661,7074356,13477017
Guatemala,GTM,2008,6568347,7170952,13739299
Guatemala,GTM,2009,6734651,7265539,14000190
Guatemala,GTM,2010,6902116,7357571,14259687
Guatemala,GTM,2011,7072123,7449392,14521515
Guatemala,GTM,2012,7243152,7538790,14781942
Guatemala,GTM,2013,7418337,7625644,15043981
Guatemala,GTM,2014,7597137,7709179,15306316
Guatemala,GTM,2015,7779195,7788224,15567419
Guatemala,GTM,2016,7964335,7863355,15827690
Guatemala,GTM,2017,8153103,7934315,16087418
Guatemala,GTM,2018,8345772,8001178,16346950
Guatemala,GTM,2019,8540945,8063081,16604026
Guatemala,GTM,2020,8738685,8119648,16858333
Guatemala,GTM,2021,8938987,8170759,17109746
Guinea,GIN,1960,368281,3148533,3516814
Guinea,GIN,1961,391359,3187272,3578631
Guinea,GIN,1962,415881,3226443,3642324
Guinea,GIN,1963,441950,3265995,3707945
Guinea,GIN,1964,469636,3305874,3775510
Guinea,GIN,1965,499014,3346060,3845074
Guinea,GIN,1966,530215,3386565,3916780
Guinea,GIN,1967,563336,3427424,3990760
Guinea,GIN,1968,598549,3468784,4067333
Guinea,GIN,1969,635707,3509487,4145194
Guinea,GIN,1970,674609,3547765,4222374
Guinea,GIN,1971,715245,3582842,4298087
Guinea,GIN,1972,757573,3614639,4372212
Guinea,GIN,1973,801604,3643603,4445207
Guinea,GIN,1974,847538,3669535,4517073
Guinea,GIN,1975,895349,3692657,4588006
Guinea,GIN,1976,945306,3713437,4658743
Guinea,GIN,1977,997494,3732881,4730375
Guinea,GIN,1978,1052615,3752311,4804926
Guinea,GIN,1979,1111383,3773816,4885199
Guinea,GIN,1980,1174381,3798228,4972609
Guinea,GIN,1981,1241672,3825755,5067427
Guinea,GIN,1982,1314090,3856641,5170731
Guinea,GIN,1983,1377194,3905080,5282274
Guinea,GIN,1984,1423233,3978851,5402084
Guinea,GIN,1985,1472583,4059078,5531661
Guinea,GIN,1986,1525488,4145892,5671380
Guinea,GIN,1987,1581970,4238804,5820774
Guinea,GIN,1988,1641272,4335903,5977175
Guinea,GIN,1989,1702234,4433932,6136166
Guinea,GIN,1990,1780813,4573332,6354145
Guinea,GIN,1991,1873047,4742687,6615734
Guinea,GIN,1992,1954076,4878119,6832195
Guinea,GIN,1993,2035617,5010480,7046097
Guinea,GIN,1994,2119230,5142882,7262112
Guinea,GIN,1995,2201295,5267052,7468347
Guinea,GIN,1996,2287263,5395852,7683115
Guinea,GIN,1997,2356920,5485886,7842806
Guinea,GIN,1998,2423579,5568966,7992545
Guinea,GIN,1999,2501110,5673787,8174897
Guinea,GIN,2000,2573538,5763429,8336967
Guinea,GIN,2001,2630334,5815383,8445717
Guinea,GIN,2002,2695142,5882648,8577790
Guinea,GIN,2003,2780629,5991625,8772254
Guinea,GIN,2004,2865471,6095568,8961039
Guinea,GIN,2005,2948327,6191787,9140114
Guinea,GIN,2006,3036092,6294533,9330625
Guinea,GIN,2007,3133543,6413539,9547082
Guinea,GIN,2008,3237696,6542089,9779785
Guinea,GIN,2009,3346220,6675103,10021323
Guinea,GIN,2010,3458976,6811752,10270728
Guinea,GIN,2011,3575843,6951869,10527712
Guinea,GIN,2012,3695666,7093026,10788692
Guinea,GIN,2013,3819098,7236332,11055430
Guinea,GIN,2014,3948091,7385274,11333365
Guinea,GIN,2015,4085492,7540506,11625998
Guinea,GIN,2016,4230727,7700258,11930985
Guinea,GIN,2017,4381346,7859443,12240789
Guinea,GIN,2018,4537328,8017536,12554864
Guinea,GIN,2019,4700302,8177237,12877539
Guinea,GIN,2020,4869400,8335753,13205153
Guinea,GIN,2021,5042529,8489377,13531906
Guinea-Bissau,GNB,1960,78599,499334,577933
Guinea-Bissau,GNB,1961,80160,502947,583107
Guinea-Bissau,GNB,1962,82036,508363,590399
Guinea-Bissau,GNB,1963,83680,512122,595802
Guinea-Bissau,GNB,1964,83831,506650,590481
Guinea-Bissau,GNB,1965,82885,494753,577638
Guinea-Bissau,GNB,1966,82721,487654,570375
Guinea-Bissau,GNB,1967,84046,489334,573380
Guinea-Bissau,GNB,1968,86442,497033,583475
Guinea-Bissau,GNB,1969,88017,499863,587880
Guinea-Bissau,GNB,1970,89530,502133,591663
Guinea-Bissau,GNB,1971,90917,503584,594501
Guinea-Bissau,GNB,1972,92104,503846,595950
Guinea-Bissau,GNB,1973,94208,508995,603203
Guinea-Bissau,GNB,1974,98419,525157,623576
Guinea-Bissau,GNB,1975,105212,554423,659635
Guinea-Bissau,GNB,1976,112990,588026,701016
Guinea-Bissau,GNB,1977,121597,624991,746588
Guinea-Bissau,GNB,1978,130723,663605,794328
Guinea-Bissau,GNB,1979,137782,683816,821598
Guinea-Bissau,GNB,1980,148033,683429,831462
Guinea-Bissau,GNB,1981,159553,685404,844957
Guinea-Bissau,GNB,1982,171838,686792,858630
Guinea-Bissau,GNB,1983,184895,687499,872394
Guinea-Bissau,GNB,1984,198741,687469,886210
Guinea-Bissau,GNB,1985,213357,686731,900088
Guinea-Bissau,GNB,1986,228841,685281,914122
Guinea-Bissau,GNB,1987,245220,683188,928408
Guinea-Bissau,GNB,1988,262563,680517,943080
Guinea-Bissau,GNB,1989,280879,677360,958239
Guinea-Bissau,GNB,1990,300146,673405,973551
Guinea-Bissau,GNB,1991,321910,671946,993856
Guinea-Bissau,GNB,1992,340330,682574,1022904
Guinea-Bissau,GNB,1993,355442,701319,1056761
Guinea-Bissau,GNB,1994,370492,719125,1089617
Guinea-Bissau,GNB,1995,384000,733222,1117222
Guinea-Bissau,GNB,1996,396269,744335,1140604
Guinea-Bissau,GNB,1997,408180,754263,1162443
Guinea-Bissau,GNB,1998,420203,763868,1184071
Guinea-Bissau,GNB,1999,432702,773772,1206474
Guinea-Bissau,GNB,2000,446097,784752,1230849
Guinea-Bissau,GNB,2001,460478,796902,1257380
Guinea-Bissau,GNB,2002,475752,809926,1285678
Guinea-Bissau,GNB,2003,491883,823770,1315653
Guinea-Bissau,GNB,2004,508792,838217,1347009
Guinea-Bissau,GNB,2005,526457,853256,1379713
Guinea-Bissau,GNB,2006,545061,869030,1414091
Guinea-Bissau,GNB,2007,564766,885806,1450572
Guinea-Bissau,GNB,2008,585325,903106,1488431
Guinea-Bissau,GNB,2009,606541,920655,1527196
Guinea-Bissau,GNB,2010,628628,938592,1567220
Guinea-Bissau,GNB,2011,651781,957236,1609017
Guinea-Bissau,GNB,2012,676093,976624,1652717
Guinea-Bissau,GNB,2013,701342,996411,1697753
Guinea-Bissau,GNB,2014,727221,1016088,1743309
Guinea-Bissau,GNB,2015,753546,1035373,1788919
Guinea-Bissau,GNB,2016,780290,1054262,1834552
Guinea-Bissau,GNB,2017,807291,1072535,1879826
Guinea-Bissau,GNB,2018,834660,1090295,1924955
Guinea-Bissau,GNB,2019,862607,1107850,1970457
Guinea-Bissau,GNB,2020,890915,1124913,2015828
Guinea-Bissau,GNB,2021,919432,1141289,2060721
Guyana,GUY,1960,165929,406061,571990
Guyana,GUY,1961,170982,417615,588597
Guyana,GUY,1962,175940,428893,604833
Guyana,GUY,1963,180805,439898,620703
Guyana,GUY,1964,185502,450455,635957
Guyana,GUY,1965,189919,460288,650207
Guyana,GUY,1966,193991,469250,663241
Guyana,GUY,1967,197719,477345,675064
Guyana,GUY,1968,201164,484723,685887
Guyana,GUY,1969,204384,491535,695919
Guyana,GUY,1970,207523,497738,705261
Guyana,GUY,1971,210837,503067,713904
Guyana,GUY,1972,214006,507988,721994
Guyana,GUY,1973,217135,512730,729865
Guyana,GUY,1974,220263,517438,737701
Guyana,GUY,1975,223431,522159,745590
Guyana,GUY,1976,226639,526914,753553
Guyana,GUY,1977,229830,531548,761378
Guyana,GUY,1978,232850,535759,768609
Guyana,GUY,1979,235481,539001,774482
Guyana,GUY,1980,237250,540926,778176
Guyana,GUY,1981,236993,542693,779686
Guyana,GUY,1982,236270,543369,779639
Guyana,GUY,1983,235185,543187,778372
Guyana,GUY,1984,233764,542243,776007
Guyana,GUY,1985,232056,540615,772671
Guyana,GUY,1986,230114,538394,768508
Guyana,GUY,1987,227989,535717,763706
Guyana,GUY,1988,225737,532713,758450
Guyana,GUY,1989,223407,529490,752897
Guyana,GUY,1990,221019,526097,747116
Guyana,GUY,1991,219456,524640,744096
Guyana,GUY,1992,219059,525939,744998
Guyana,GUY,1993,219038,528151,747189
Guyana,GUY,1994,219062,530484,749546
Guyana,GUY,1995,219020,532669,751689
Guyana,GUY,1996,218897,534674,753571
Guyana,GUY,1997,218702,536509,755211
Guyana,GUY,1998,218466,538231,756697
Guyana,GUY,1999,218172,539842,758014
Guyana,GUY,2000,217802,541249,759051
Guyana,GUY,2001,217351,542458,759809
Guyana,GUY,2002,216829,543494,760323
Guyana,GUY,2003,215292,545270,760562
Guyana,GUY,2004,213405,547019,760424
Guyana,GUY,2005,211366,548343,759709
Guyana,GUY,2006,209173,549194,758367
Guyana,GUY,2007,206856,549665,756521
Guyana,GUY,2008,204412,549738,754150
Guyana,GUY,2009,201856,549402,751258
Guyana,GUY,2010,199204,548728,747932
Guyana,GUY,2011,196477,547753,744230
Guyana,GUY,2012,196407,547559,743966
Guyana,GUY,2013,197319,550101,747420
Guyana,GUY,2014,198400,552715,751115
Guyana,GUY,2015,199638,555393,755031
Guyana,GUY,2016,201021,558066,759087
Guyana,GUY,2017,202552,560700,763252
Guyana,GUY,2018,208994,576520,785514
Guyana,GUY,2019,213179,585574,798753
Guyana,GUY,2020,213539,583663,797202
Guyana,GUY,2021,216404,588163,804567
Haiti,HTI,1960,608305,3292834,3901139
Haiti,HTI,1961,634996,3339938,3974934
Haiti,HTI,1962,662701,3386803,4049504
Haiti,HTI,1963,690973,3431287,4122260
Haiti,HTI,1964,720429,3475920,4196349
Haiti,HTI,1965,751430,3522918,4274348
Haiti,HTI,1966,783574,3569375,4352949
Haiti,HTI,1967,816905,3615811,4432716
Haiti,HTI,1968,851612,3662394,4514006
Haiti,HTI,1969,887612,3709030,4596642
Haiti,HTI,1970,925022,3755790,4680812
Haiti,HTI,1971,963866,3802557,4766423
Haiti,HTI,1972,986299,3866818,4853117
Haiti,HTI,1973,1005434,3935276,4940710
Haiti,HTI,1974,1025096,4005556,5030652
Haiti,HTI,1975,1045615,4078945,5124560
Haiti,HTI,1976,1066977,4155365,5222342
Haiti,HTI,1977,1089202,4234625,5323827
Haiti,HTI,1978,1112117,4316550,5428667
Haiti,HTI,1979,1135686,4400737,5536423
Haiti,HTI,1980,1159884,4486792,5646676
Haiti,HTI,1981,1184757,4575440,5760197
Haiti,HTI,1982,1210509,4667175,5877684
Haiti,HTI,1983,1281117,4716622,5997739
Haiti,HTI,1984,1364561,4755371,6119932
Haiti,HTI,1985,1452775,4792764,6245539
Haiti,HTI,1986,1546280,4828817,6375097
Haiti,HTI,1987,1645115,4863234,6508349
Haiti,HTI,1988,1749551,4895408,6644959
Haiti,HTI,1989,1859199,4924962,6784161
Haiti,HTI,1990,1974412,4950919,6925331
Haiti,HTI,1991,2094449,4971606,7066055
Haiti,HTI,1992,2219380,4986400,7205780
Haiti,HTI,1993,2305891,5040049,7345940
Haiti,HTI,1994,2394576,5091515,7486091
Haiti,HTI,1995,2485742,5141574,7627316
Haiti,HTI,1996,2579837,5190756,7770593
Haiti,HTI,1997,2674695,5240477,7915172
Haiti,HTI,1998,2772062,5288834,8060896
Haiti,HTI,1999,2872473,5336468,8208941
Haiti,HTI,2000,2976240,5383985,8360225
Haiti,HTI,2001,3170704,5341024,8511728
Haiti,HTI,2002,3372373,5289173,8661546
Haiti,HTI,2003,3581737,5230508,8812245
Haiti,HTI,2004,3735059,5226430,8961489
Haiti,HTI,2005,3885132,5226768,9111900
Haiti,HTI,2006,4040472,5225816,9266288
Haiti,HTI,2007,4199239,5221587,9420826
Haiti,HTI,2008,4361621,5213626,9575247
Haiti,HTI,2009,4527471,5203167,9730638
Haiti,HTI,2010,4676254,5166626,9842880
Haiti,HTI,2011,4827045,5127267,9954312
Haiti,HTI,2012,5001402,5107137,10108539
Haiti,HTI,2013,5177805,5083401,10261206
Haiti,HTI,2014,5356730,5056010,10412740
Haiti,HTI,2015,5538261,5025496,10563757
Haiti,HTI,2016,5720767,4993082,10713849
Haiti,HTI,2017,5903901,4959642,10863543
Haiti,HTI,2018,6087446,4924975,11012421
Haiti,HTI,2019,6271273,4889165,11160438
Haiti,HTI,2020,6454827,4851974,11306801
Haiti,HTI,2021,6635469,4812100,11447569
High-income countries,,1960,489658373,289884000,779542373
High-income countries,,1961,499711796,289593500,789305296
High-income countries,,1962,510044221,289248160,799292381
High-income countries,,1963,520550914,288633570,809184484
High-income countries,,1964,531138780,287914020,819052800
High-income countries,,1965,541622651,287000860,828623511
High-income countries,,1966,551787127,285941120,837728247
High-income countries,,1967,561900185,284567420,846467605
High-income countries,,1968,571906241,283201300,855107541
High-income countries,,1969,581828621,282025380,863854001
High-income countries,,1970,591648751,280895040,872543791
High-income countries,,1971,602211855,280669150,882881005
High-income countries,,1972,611683452,280261600,891945052
High-income countries,,1973,620940344,279762080,900702424
High-income countries,,1974,630119760,279172930,909292690
High-income countries,,1975,639076387,278601470,917677857
High-income countries,,1976,647170312,278307700,925478012
High-income countries,,1977,655213482,277965000,933178482
High-income countries,,1978,663413364,277537860,940951224
High-income countries,,1979,671859803,277142340,949002143
High-income countries,,1980,680189488,276600640,956790128
High-income countries,,1981,688749018,275774270,964523288
High-income countries,,1982,696632297,275176900,971809197
High-income countries,,1983,703997351,274583940,978581291
High-income countries,,1984,710980880,273976300,984957180
High-income countries,,1985,717987002,273409340,991396342
High-income countries,,1986,725463937,272582500,998046437
High-income countries,,1987,733356426,271486560,1004842986
High-income countries,,1988,741315307,270515170,1011830477
High-income countries,,1989,749399354,269926140,1019325494
High-income countries,,1990,757439038,269238620,1026677658
High-income countries,,1991,766569268,268484100,1035053368
High-income countries,,1992,775741362,267911630,1043652992
High-income countries,,1993,784386904,267412380,1051799284
High-income countries,,1994,792618264,266698770,1059317034
High-income countries,,1995,800597150,265869800,1066466950
High-income countries,,1996,808581300,265131500,1073712800
High-income countries,,1997,816365816,264462200,1080828016
High-income countries,,1998,824018287,263740530,1087758817
High-income countries,,1999,831612012,262980420,1094592432
High-income countries,,2000,839091772,262200980,1101292752
High-income countries,,2001,847957779,260063790,1108021569
High-income countries,,2002,857542072,257290130,1114832202
High-income countries,,2003,866916014,254748690,1121664704
High-income countries,,2004,876369501,252351580,1128721081
High-income countries,,2005,886016450,250114510,1136130960
High-income countries,,2006,896315848,248345020,1144660868
High-income countries,,2007,907142967,246801000,1153943967
High-income countries,,2008,918189482,245374180,1163563662
High-income countries,,2009,928347146,243877040,1172224186
High-income countries,,2010,937411084,242208800,1179619884
High-income countries,,2011,943832637,240806580,1184639217
High-income countries,,2012,951139649,240068770,1191208419
High-income countries,,2013,958580837,239401540,1197982377
High-income countries,,2014,966099548,238748130,1204847678
High-income countries,,2015,973637991,237964770,1211602761
High-income countries,,2016,981367682,237142910,1218510592
High-income countries,,2017,988569205,236129460,1224698665
High-income countries,,2018,995637723,235006660,1230644383
High-income countries,,2019,1002221498,233614620,1235836118
High-income countries,,2020,1008611990,232256420,1240868410
High-income countries,,2021,1010683527,229914380,1240597907
Honduras,HND,1960,472823,1605794,2078617
Honduras,HND,1961,498988,1640940,2139928
Honduras,HND,1962,526482,1676372,2202854
Honduras,HND,1963,555384,1712324,2267708
Honduras,HND,1964,585817,1748675,2334492
Honduras,HND,1965,617787,1785678,2403465
Honduras,HND,1966,651418,1823105,2474523
Honduras,HND,1967,686678,1860819,2547497
Honduras,HND,1968,723838,1899144,2622982
Honduras,HND,1969,762978,1938403,2701381
Honduras,HND,1970,804271,1978482,2782753
Honduras,HND,1971,847891,2019610,2867501
Honduras,HND,1972,894078,2061943,2956021
Honduras,HND,1973,942349,2104366,3046715
Honduras,HND,1974,990237,2146302,3136539
Honduras,HND,1975,1037677,2193954,3231631
Honduras,HND,1976,1088917,2245897,3334814
Honduras,HND,1977,1142453,2298669,3441122
Honduras,HND,1978,1198320,2352048,3550368
Honduras,HND,1979,1256648,2406088,3662736
Honduras,HND,1980,1317385,2460605,3777990
Honduras,HND,1981,1380454,2515282,3895736
Honduras,HND,1982,1445794,2569853,4015647
Honduras,HND,1983,1513477,2624307,4137784
Honduras,HND,1984,1583516,2678403,4261919
Honduras,HND,1985,1655696,2731997,4387693
Honduras,HND,1986,1730321,2785247,4515568
Honduras,HND,1987,1807515,2838218,4645733
Honduras,HND,1988,1886447,2891667,4778114
Honduras,HND,1989,1963947,2949729,4913676
Honduras,HND,1990,2044538,3008696,5053234
Honduras,HND,1991,2128281,3068606,5196887
Honduras,HND,1992,2215302,3129472,5344774
Honduras,HND,1993,2305540,3191301,5496841
Honduras,HND,1994,2399162,3253772,5652934
Honduras,HND,1995,2496088,3316744,5812832
Honduras,HND,1996,2596333,3380217,5976550
Honduras,HND,1997,2699969,3444143,6144112
Honduras,HND,1998,2803955,3504582,6308537
Honduras,HND,1999,2911705,3565660,6477365
Honduras,HND,2000,3026014,3630711,6656725
Honduras,HND,2001,3142954,3694907,6837861
Honduras,HND,2002,3271979,3747929,7019908
Honduras,HND,2003,3404113,3797768,7201881
Honduras,HND,2004,3538645,3844762,7383407
Honduras,HND,2005,3675267,3889346,7564613
Honduras,HND,2006,3814124,3931076,7745200
Honduras,HND,2007,3954703,3969759,7924462
Honduras,HND,2008,4096745,4005032,8101777
Honduras,HND,2009,4240048,4037254,8277302
Honduras,HND,2010,4384767,4066166,8450933
Honduras,HND,2011,4530522,4091982,8622504
Honduras,HND,2012,4677715,4114652,8792367
Honduras,HND,2013,4826031,4134626,8960657
Honduras,HND,2014,4975954,4151892,9127846
Honduras,HND,2015,5127314,4167191,9294505
Honduras,HND,2016,5280355,4180443,9460798
Honduras,HND,2017,5435026,4191816,9626842
Honduras,HND,2018,5591326,4201524,9792850
Honduras,HND,2019,5749232,4209597,9958829
Honduras,HND,2020,5906960,4214803,10121763
Honduras,HND,2021,6062373,4215972,10278345
Hong Kong,HKG,1960,2653700,460971,3114671
Hong Kong,HKG,1961,2702168,465932,3168100
Hong Kong,HKG,1962,2828656,476544,3305200
Hong Kong,HKG,1963,2937424,483476,3420900
Hong Kong,HKG,1964,3019108,485492,3504600
Hong Kong,HKG,1965,3109377,488523,3597900
Hong Kong,HKG,1966,3146833,483067,3629900
Hong Kong,HKG,1967,3237272,485528,3722800
Hong Kong,HKG,1968,3316715,485985,3802700
Hong Kong,HKG,1969,3379985,483915,3863900
Hong Kong,HKG,1970,3473191,485809,3959000
Hong Kong,HKG,1971,3561442,483858,4045300
Hong Kong,HKG,1972,3648314,475286,4123600
Hong Kong,HKG,1973,3770528,471072,4241600
Hong Kong,HKG,1974,3909419,468381,4377800
Hong Kong,HKG,1975,4001832,459768,4461600
Hong Kong,HKG,1976,4069679,448321,4518000
Hong Kong,HKG,1977,4145727,437973,4583700
Hong Kong,HKG,1978,4238137,429363,4667500
Hong Kong,HKG,1979,4493175,436525,4929700
Hong Kong,HKG,1980,4631623,431477,5063100
Hong Kong,HKG,1981,4758050,425350,5183400
Hong Kong,HKG,1982,4848078,416422,5264500
Hong Kong,HKG,1983,4937590,407510,5345100
Hong Kong,HKG,1984,5001316,396584,5397900
Hong Kong,HKG,1985,5069901,386299,5456200
Hong Kong,HKG,1986,5206825,317775,5524600
Hong Kong,HKG,1987,5405272,175228,5580500
Hong Kong,HKG,1988,5532437,95163,5627600
Hong Kong,HKG,1989,5634683,51517,5686200
Hong Kong,HKG,1990,5676947,27553,5704500
Hong Kong,HKG,1991,5742337,9663,5752000
Hong Kong,HKG,1992,5799282,1218,5800500
Hong Kong,HKG,1993,5901000,0,5901000
Hong Kong,HKG,1994,6035400,0,6035400
Hong Kong,HKG,1995,6156100,0,6156100
Hong Kong,HKG,1996,6435500,0,6435500
Hong Kong,HKG,1997,6489300,0,6489300
Hong Kong,HKG,1998,6543700,0,6543700
Hong Kong,HKG,1999,6606500,0,6606500
Hong Kong,HKG,2000,6665000,0,6665000
Hong Kong,HKG,2001,6714300,0,6714300
Hong Kong,HKG,2002,6744100,0,6744100
Hong Kong,HKG,2003,6730800,0,6730800
Hong Kong,HKG,2004,6783500,0,6783500
Hong Kong,HKG,2005,6813200,0,6813200
Hong Kong,HKG,2006,6857100,0,6857100
Hong Kong,HKG,2007,6916300,0,6916300
Hong Kong,HKG,2008,6957800,0,6957800
Hong Kong,HKG,2009,6972800,0,6972800
Hong Kong,HKG,2010,7024200,0,7024200
Hong Kong,HKG,2011,7071600,0,7071600
Hong Kong,HKG,2012,7150100,0,7150100
Hong Kong,HKG,2013,7178900,0,7178900
Hong Kong,HKG,2014,7229500,0,7229500
Hong Kong,HKG,2015,7291300,0,7291300
Hong Kong,HKG,2016,7336600,0,7336600
Hong Kong,HKG,2017,7393200,0,7393200
Hong Kong,HKG,2018,7452600,0,7452600
Hong Kong,HKG,2019,7507900,0,7507900
Hong Kong,HKG,2020,7481000,0,7481000
Hong Kong,HKG,2021,7413100,0,7413100
Hungary,HUN,1960,5582136,4401831,9983967
Hungary,HUN,1961,5650018,4379303,10029321
Hungary,HUN,1962,5710839,4350895,10061734
Hungary,HUN,1963,5768389,4319558,10087947
Hungary,HUN,1964,5829329,4290506,10119835
Hungary,HUN,1965,5888035,4259900,10147935
Hungary,HUN,1966,5948507,4230146,10178653
Hungary,HUN,1967,6013391,4203213,10216604
Hungary,HUN,1968,6079237,4176578,10255815
Hungary,HUN,1969,6147411,4151312,10298723
Hungary,HUN,1970,6214324,4123586,10337910
Hungary,HUN,1971,6276403,4091134,10367537
Hungary,HUN,1972,6339439,4059050,10398489
Hungary,HUN,1973,6404030,4028025,10432055
Hungary,HUN,1974,6476897,4001823,10478720
Hungary,HUN,1975,6559474,3981051,10540525
Hungary,HUN,1976,6640071,3958606,10598677
Hungary,HUN,1977,6715287,3932744,10648031
Hungary,HUN,1978,6782725,3902097,10684822
Hungary,HUN,1979,6839204,3864948,10704152
Hungary,HUN,1980,6875576,3835546,10711122
Hungary,HUN,1981,6895431,3816417,10711848
Hungary,HUN,1982,6910744,3794791,10705535
Hungary,HUN,1983,6919717,3769746,10689463
Hungary,HUN,1984,6925194,3742901,10668095
Hungary,HUN,1985,6931780,3716933,10648713
Hungary,HUN,1986,6938994,3691570,10630564
Hungary,HUN,1987,6946357,3666384,10612741
Hungary,HUN,1988,6954686,3641801,10596487
Hungary,HUN,1989,6898019,3583700,10481719
Hungary,HUN,1990,6830026,3543962,10373988
Hungary,HUN,1991,6816672,3556728,10373400
Hungary,HUN,1992,6800940,3568401,10369341
Hungary,HUN,1993,6780138,3577385,10357523
Hungary,HUN,1994,6757831,3585524,10343355
Hungary,HUN,1995,6735415,3593550,10328965
Hungary,HUN,1996,6710863,3600375,10311238
Hungary,HUN,1997,6684288,3606198,10290486
Hungary,HUN,1998,6655715,3610855,10266570
Hungary,HUN,1999,6623887,3613643,10237530
Hungary,HUN,2000,6593735,3617236,10210971
Hungary,HUN,2001,6588305,3599271,10187576
Hungary,HUN,2002,6611324,3547284,10158608
Hungary,HUN,2003,6633742,3495810,10129552
Hungary,HUN,2004,6660205,3446941,10107146
Hungary,HUN,2005,6694281,3392784,10087065
Hungary,HUN,2006,6737243,3334127,10071370
Hungary,HUN,2007,6779707,3276073,10055780
Hungary,HUN,2008,6820246,3217942,10038188
Hungary,HUN,2009,6861506,3161144,10022650
Hungary,HUN,2010,6891116,3108907,10000023
Hungary,HUN,2011,6916190,3055537,9971727
Hungary,HUN,2012,6912310,3008052,9920362
Hungary,HUN,2013,6920508,2972574,9893082
Hungary,HUN,2014,6928924,2937544,9866468
Hungary,HUN,2015,6939335,2903693,9843028
Hungary,HUN,2016,6946267,2867756,9814023
Hungary,HUN,2017,6955524,2832442,9787966
Hungary,HUN,2018,6974963,2800601,9775564
Hungary,HUN,2019,7000436,2770705,9771141
Hungary,HUN,2020,7014452,2735697,9750149
Hungary,HUN,2021,7014911,2694980,9709891
Iceland,ISL,1960,140986,34588,175574
Iceland,ISL,1961,144661,34368,179029
Iceland,ISL,1962,148268,34110,182378
Iceland,ISL,1963,151829,33824,185653
Iceland,ISL,1964,155450,33533,188983
Iceland,ISL,1965,159059,33227,192286
Iceland,ISL,1966,162665,32905,195570
Iceland,ISL,1967,166198,32553,198751
Iceland,ISL,1968,169365,32123,201488
Iceland,ISL,1969,171812,31557,203369
Iceland,ISL,1970,173568,30870,204438
Iceland,ISL,1971,175738,30360,206098
Iceland,ISL,1972,179084,30053,209137
Iceland,ISL,1973,182557,29760,212317
Iceland,ISL,1974,185790,29419,215209
Iceland,ISL,1975,188920,29059,217979
Iceland,ISL,1976,191538,28616,220154
Iceland,ISL,1977,193688,28111,221799
Iceland,ISL,1978,195917,27620,223537
Iceland,ISL,1979,198545,27190,225735
Iceland,ISL,1980,201355,26783,228138
Iceland,ISL,1981,204294,26461,230755
Iceland,ISL,1982,207668,26192,233860
Iceland,ISL,1983,211056,25921,236977
Iceland,ISL,1984,213929,25582,239511
Iceland,ISL,1985,216226,25179,241405
Iceland,ISL,1986,218415,24765,243180
Iceland,ISL,1987,221413,24446,245859
Iceland,ISL,1988,225500,24240,249740
Iceland,ISL,1989,228892,23960,252852
Iceland,ISL,1990,231255,23571,254826
Iceland,ISL,1991,234420,23377,257797
Iceland,ISL,1992,237854,23203,261057
Iceland,ISL,1993,240747,22978,263725
Iceland,ISL,1994,243303,22718,266021
Iceland,ISL,1995,245081,22387,267468
Iceland,ISL,1996,246857,22059,268916
Iceland,ISL,1997,249329,21799,271128
Iceland,ISL,1998,252455,21592,274047
Iceland,ISL,1999,255931,21450,277381
Iceland,ISL,2000,259836,21369,281205
Iceland,ISL,2001,263687,21281,284968
Iceland,ISL,2002,266425,21098,287523
Iceland,ISL,2003,268644,20877,289521
Iceland,ISL,2004,271378,20696,292074
Iceland,ISL,2005,276072,20662,296734
Iceland,ISL,2006,283000,20782,303782
Iceland,ISL,2007,290623,20943,311566
Iceland,ISL,2008,296449,20965,317414
Iceland,ISL,2009,297832,20667,318499
Iceland,ISL,2010,297604,20437,318041
Iceland,ISL,2011,298556,20458,319014
Iceland,ISL,2012,300190,20526,320716
Iceland,ISL,2013,303150,20614,323764
Iceland,ISL,2014,306653,20733,327386
Iceland,ISL,2015,309974,20841,330815
Iceland,ISL,2016,314424,21015,335439
Iceland,ISL,2017,322016,21384,343400
Iceland,ISL,2018,330898,21823,352721
Iceland,ISL,2019,338406,22157,360563
Iceland,ISL,2020,344101,22362,366463
Iceland,ISL,2021,349960,22560,372520
India,IND,1960,79932899,366021700,445954599
India,IND,1961,82289370,374062500,456351870
India,IND,1962,85082467,381941730,467024197
India,IND,1963,87963683,389969920,477933603
India,IND,1964,90940579,398118720,489059299
India,IND,1965,93946480,406167870,500114350
India,IND,1966,96971069,414021540,510992609
India,IND,1967,100070141,421916930,521987071
India,IND,1968,103304423,430127500,533431923
India,IND,1969,106674456,438640220,545314676
India,IND,1970,110162257,447339040,557501297
India,IND,1971,113948536,456050660,569999196
India,IND,1972,118438504,464399460,582837964
India,IND,1973,123114078,472993400,596107478
India,IND,1974,127986735,481735230,609721965
India,IND,1975,133010186,490514050,623524236
India,IND,1976,138180350,499271100,637451450
India,IND,1977,143540276,508145340,651685616
India,IND,1978,149104062,517163700,666267762
India,IND,1979,154888632,526359740,681248372
India,IND,1980,160953420,535874980,696828400
India,IND,1981,166932604,545936700,712869304
India,IND,1982,172426704,556742800,729169504
India,IND,1983,178095921,567730600,745826521
India,IND,1984,183956909,578938240,762895149
India,IND,1985,189973343,590268740,780242083
India,IND,1986,196158550,601720450,797879000
India,IND,1987,202485214,613230900,815716114
India,IND,1988,208957670,624772030,833729700
India,IND,1989,215601807,636410900,852012707
India,IND,1990,222374415,648077760,870452175
India,IND,1991,229151406,659790340,888941746
India,IND,1992,235824041,671750000,907574041
India,IND,1993,242620668,683730600,926351268
India,IND,1994,249539704,695722240,945261944
India,IND,1995,256565748,707713400,964279148
India,IND,1996,263686524,719594700,983281224
India,IND,1997,270911166,731424060,1002335226
India,IND,1998,278238779,743195800,1021434579
India,IND,1999,285648480,754851600,1040500080
India,IND,2000,293168849,766464830,1059633679
India,IND,2001,301227098,777743800,1078970898
India,IND,2002,310207535,788105500,1098313035
India,IND,2003,319267849,798147260,1117415109
India,IND,2004,328414552,807850050,1136264602
India,IND,2005,337558628,817080060,1154638688
India,IND,2006,346659205,825714560,1172373765
India,IND,2007,355789232,833902600,1189691832
India,IND,2008,364989009,841745800,1206734809
India,IND,2009,374274816,849365400,1223640216
India,IND,2010,383721793,856891840,1240613633
India,IND,2011,393333604,864287600,1257621204
India,IND,2012,403171286,871315900,1274487186
India,IND,2013,413200994,877931100,1291132094
India,IND,2014,423338709,883907800,1307246509
India,IND,2015,433595954,889270500,1322866454
India,IND,2016,444186310,894450050,1338636360
India,IND,2017,455009748,899185900,1354195648
India,IND,2018,465871825,903131460,1369003285
India,IND,2019,476786386,906325600,1383111986
India,IND,2020,487702168,908684900,1396387068
India,IND,2021,498179071,909384770,1407563841
Indonesia,IDN,1960,12891527,75491350,88382877
Indonesia,IDN,1961,13459978,77356960,90816938
Indonesia,IDN,1962,14055964,79289530,93345494
Indonesia,IDN,1963,14681307,81281220,95962527
Indonesia,IDN,1964,15337065,83338000,98675065
Indonesia,IDN,1965,15971816,85186050,101157866
Indonesia,IDN,1966,16610166,86950936,103561102
Indonesia,IDN,1967,17313064,88947690,106260754
Indonesia,IDN,1968,18061367,91077360,109138727
Indonesia,IDN,1969,18851167,93298080,112149247
Indonesia,IDN,1970,19670639,95557750,115228389
Indonesia,IDN,1971,20519026,97828110,118347136
Indonesia,IDN,1972,21602222,99901920,121504142
Indonesia,IDN,1973,22796816,101912240,124709056
Indonesia,IDN,1974,24044741,103900456,127945197
Indonesia,IDN,1975,25346457,105866760,131213217
Indonesia,IDN,1976,26706459,107814570,134521029
Indonesia,IDN,1977,28120997,109740540,137861537
Indonesia,IDN,1978,29600552,111650420,141250972
Indonesia,IDN,1979,31143740,113549340,144693080
Indonesia,IDN,1980,32753065,115424030,148177095
Indonesia,IDN,1981,34607238,117079096,151686334
Indonesia,IDN,1982,36643277,118585384,155228661
Indonesia,IDN,1983,38768728,120021880,158790608
Indonesia,IDN,1984,40979080,121352880,162331960
Indonesia,IDN,1985,43253395,122538296,165791691
Indonesia,IDN,1986,45587030,123548240,169135270
Indonesia,IDN,1987,47993494,124427896,172421390
Indonesia,IDN,1988,50487614,125207030,175694644
Indonesia,IDN,1989,53060220,125888950,178949170
Indonesia,IDN,1990,55711776,126448100,182159876
Indonesia,IDN,1991,58598245,126762984,185361229
Indonesia,IDN,1992,61664259,126894160,188558419
Indonesia,IDN,1993,64822542,126914744,191737286
Indonesia,IDN,1994,68094384,126834150,194928534
Indonesia,IDN,1995,71481045,126659120,198140165
Indonesia,IDN,1996,74981531,126392260,201373791
Indonesia,IDN,1997,78589432,126038580,204628012
Indonesia,IDN,1998,82296223,125559260,207855483
Indonesia,IDN,1999,86069860,124927050,210996910
Indonesia,IDN,2000,89914698,124157720,214072418
Indonesia,IDN,2001,92887214,124225224,217112438
Indonesia,IDN,2002,95899743,124215350,220115093
Indonesia,IDN,2003,98949418,124130700,223080118
Indonesia,IDN,2004,102009016,123929576,225938592
Indonesia,IDN,2005,105117659,123687490,228805149
Indonesia,IDN,2006,108337481,123459944,231797425
Indonesia,IDN,2007,111639888,123218400,234858288
Indonesia,IDN,2008,115006628,122929910,237936538
Indonesia,IDN,2009,118403751,122577550,240981301
Indonesia,IDN,2010,121798233,122217940,244016173
Indonesia,IDN,2011,125020092,122079610,247099702
Indonesia,IDN,2012,128304189,121918504,250222693
Indonesia,IDN,2013,131589503,121686420,253275923
Indonesia,IDN,2014,134866535,121363224,256229759
Indonesia,IDN,2015,138129702,120962270,259091972
Indonesia,IDN,2016,141370295,120479890,261850185
Indonesia,IDN,2017,144572428,119926424,264498852
Indonesia,IDN,2018,147754731,119312110,267066841
Indonesia,IDN,2019,150925974,118656904,269582878
Indonesia,IDN,2020,153983073,117874900,271857973
Indonesia,IDN,2021,156833203,116919980,273753183
Iran,IRN,1960,7215514,14173292,21388806
Iran,IRN,1961,7559948,14423674,21983622
Iran,IRN,1962,7923296,14681754,22605050
Iran,IRN,1963,8307683,14951411,23259094
Iran,IRN,1964,8715144,15233480,23948624
Iran,IRN,1965,9143573,15523453,24667026
Iran,IRN,1966,9588517,15810183,25398700
Iran,IRN,1967,10076232,16057109,26133341
Iran,IRN,1968,10598813,16276489,26875302
Iran,IRN,1969,11146210,16497475,27643685
Iran,IRN,1970,11724692,16725013,28449705
Iran,IRN,1971,12327147,16946536,29273683
Iran,IRN,1972,12952192,17159382,30111574
Iran,IRN,1973,13607250,17374648,30981898
Iran,IRN,1974,14299406,17596128,31895534
Iran,IRN,1975,15031081,17825896,32856977
Iran,IRN,1976,15792269,18048792,33841061
Iran,IRN,1977,16555873,18320624,34876497
Iran,IRN,1978,17352544,18641116,35993660
Iran,IRN,1979,18212226,18992788,37205014
Iran,IRN,1980,19142074,19378590,38520664
Iran,IRN,1981,20413792,20062460,40476252
Iran,IRN,1982,21749390,20750640,42500030
Iran,IRN,1983,22857569,21170416,44027985
Iran,IRN,1984,24026548,21601854,45628402
Iran,IRN,1985,25237766,22028394,47266160
Iran,IRN,1986,26478203,22435034,48913237
Iran,IRN,1987,27654787,22886704,50541491
Iran,IRN,1988,28795455,23316412,52111867
Iran,IRN,1989,29930544,23714192,53644736
Iran,IRN,1990,31428551,24365078,55793629
Iran,IRN,1991,32976516,25014368,57990884
Iran,IRN,1992,34229748,25142268,59372016
Iran,IRN,1993,34968280,24787150,59755430
Iran,IRN,1994,35619538,24366212,59985750
Iran,IRN,1995,36620361,24174448,60794809
Iran,IRN,1996,37628601,23969776,61598377
Iran,IRN,1997,38646084,23834448,62480532
Iran,IRN,1998,39719234,23742188,63461422
Iran,IRN,1999,40824119,23650626,64474745
Iran,IRN,2000,41975934,23568448,65544382
Iran,IRN,2001,43177300,23497552,66674852
Iran,IRN,2002,44077717,23249400,67327117
Iran,IRN,2003,44966983,22987716,67954699
Iran,IRN,2004,46180851,22880824,69061675
Iran,IRN,2005,47413957,22768636,70182593
Iran,IRN,2006,48637866,22637894,71275760
Iran,IRN,2007,49802044,22517374,72319418
Iran,IRN,2008,50925490,22392904,73318394
Iran,IRN,2009,52059325,22263360,74322685
Iran,IRN,2010,53233539,22140316,75373855
Iran,IRN,2011,54356195,21986776,76342971
Iran,IRN,2012,55484160,21840292,77324452
Iran,IRN,2013,56721882,21737046,78458928
Iran,IRN,2014,58236086,21725586,79961672
Iran,IRN,2015,60000125,21790716,81790841
Iran,IRN,2016,61546643,21759588,83306231
Iran,IRN,2017,62866706,21638370,84505076
Iran,IRN,2018,64125842,21491720,85617562
Iran,IRN,2019,65261618,21302584,86564202
Iran,IRN,2020,66230561,21059632,87290193
Iran,IRN,2021,67125144,20798288,87923432
Iraq,IRQ,1960,3039256,4045422,7084678
Iraq,IRQ,1961,3226080,4034634,7260714
Iraq,IRQ,1962,3439997,4041835,7481832
Iraq,IRQ,1963,3676992,4058832,7735824
Iraq,IRQ,1964,3926289,4071366,7997655
Iraq,IRQ,1965,4189113,4081431,8270544
Iraq,IRQ,1966,4436728,4117155,8553883
Iraq,IRQ,1967,4684839,4163663,8848502
Iraq,IRQ,1968,4946143,4209989,9156132
Iraq,IRQ,1969,5220640,4256097,9476737
Iraq,IRQ,1970,5509464,4301883,9811347
Iraq,IRQ,1971,5810041,4344887,10154928
Iraq,IRQ,1972,6122507,4384808,10507315
Iraq,IRQ,1973,6448592,4423547,10872139
Iraq,IRQ,1974,6785351,4457795,11243146
Iraq,IRQ,1975,7130780,4486842,11617622
Iraq,IRQ,1976,7487349,4511993,11999342
Iraq,IRQ,1977,7862216,4537974,12400190
Iraq,IRQ,1978,8227432,4592275,12819707
Iraq,IRQ,1979,8582403,4651427,13233830
Iraq,IRQ,1980,8945824,4707545,13653369
Iraq,IRQ,1981,9310135,4757125,14067260
Iraq,IRQ,1982,9670054,4797628,14467682
Iraq,IRQ,1983,10058234,4845503,14903737
Iraq,IRQ,1984,10476679,4900353,15377032
Iraq,IRQ,1985,10833454,4920402,15753856
Iraq,IRQ,1986,11206219,4942002,16148221
Iraq,IRQ,1987,11621435,4976584,16598019
Iraq,IRQ,1988,11903373,5083973,16987346
Iraq,IRQ,1989,12190452,5252138,17442590
Iraq,IRQ,1990,12308951,5349430,17658381
Iraq,IRQ,1991,12407159,5439219,17846378
Iraq,IRQ,1992,12748074,5637599,18385673
Iraq,IRQ,1993,13343444,5952374,19295818
Iraq,IRQ,1994,13964286,6283787,20248073
Iraq,IRQ,1995,14408625,6540233,20948858
Iraq,IRQ,1996,14843067,6796265,21639332
Iraq,IRQ,1997,15275363,7055407,22330770
Iraq,IRQ,1998,15765819,7287669,23053488
Iraq,IRQ,1999,16303387,7517347,23820734
Iraq,IRQ,2000,16869783,7759075,24628858
Iraq,IRQ,2001,17429292,7996371,25425663
Iraq,IRQ,2002,18012216,8243127,26255343
Iraq,IRQ,2003,18584912,8483911,27068823
Iraq,IRQ,2004,19142440,8716508,27858948
Iraq,IRQ,2005,19734937,8963747,28698684
Iraq,IRQ,2006,19892550,9013057,28905607
Iraq,IRQ,2007,19739613,8921274,28660887
Iraq,IRQ,2008,20139353,9079028,29218381
Iraq,IRQ,2009,20893380,9395660,30289040
Iraq,IRQ,2010,21604967,9659908,31264875
Iraq,IRQ,2011,22427635,9950426,32378061
Iraq,IRQ,2012,23512763,10351684,33864447
Iraq,IRQ,2013,24693559,10788241,35481800
Iraq,IRQ,2014,25633615,11112873,36746488
Iraq,IRQ,2015,26400640,11357173,37757813
Iraq,IRQ,2016,27124936,11573007,38697943
Iraq,IRQ,2017,27844960,11776202,39621162
Iraq,IRQ,2018,28605484,11985216,40590700
Iraq,IRQ,2019,29376265,12187255,41563520
Iraq,IRQ,2020,30169923,12387061,42556984
Iraq,IRQ,2021,30960655,12572937,43533592
Ireland,IRL,1960,1278075,1550525,2828600
Ireland,IRL,1961,1282080,1542320,2824400
Ireland,IRL,1962,1293324,1542726,2836050
Ireland,IRL,1963,1306885,1545765,2852650
Ireland,IRL,1964,1319272,1547278,2866550
Ireland,IRL,1965,1330262,1547038,2877300
Ireland,IRL,1966,1347250,1541550,2888800
Ireland,IRL,1967,1387226,1515224,2902450
Ireland,IRL,1968,1427337,1488213,2915550
Ireland,IRL,1969,1469698,1462952,2932650
Ireland,IRL,1970,1516360,1440890,2957250
Ireland,IRL,1971,1563915,1428135,2992050
Ireland,IRL,1972,1597717,1439133,3036850
Ireland,IRL,1973,1634072,1451878,3085950
Ireland,IRL,1974,1672099,1465401,3137500
Ireland,IRL,1975,1710683,1478867,3189550
Ireland,IRL,1976,1747737,1490313,3238050
Ireland,IRL,1977,1782727,1499473,3282200
Ireland,IRL,1978,1819520,1509580,3329100
Ireland,IRL,1979,1855360,1518390,3373750
Ireland,IRL,1980,1888405,1524395,3412800
Ireland,IRL,1981,1921042,1531958,3453000
Ireland,IRL,1982,1944867,1540933,3485800
Ireland,IRL,1983,1964356,1546244,3510600
Ireland,IRL,1984,1982219,1550204,3532423
Ireland,IRL,1985,1991056,1547026,3538082
Ireland,IRL,1986,1997341,1542349,3539690
Ireland,IRL,1987,2002008,1538049,3540057
Ireland,IRL,1988,1997871,1527078,3524949
Ireland,IRL,1989,1994394,1516615,3511009
Ireland,IRL,1990,2000470,1513504,3513974
Ireland,IRL,1991,2017094,1517141,3534235
Ireland,IRL,1992,2038731,1519699,3558430
Ireland,IRL,1993,2056779,1519482,3576261
Ireland,IRL,1994,2072766,1517620,3590386
Ireland,IRL,1995,2091287,1517554,3608841
Ireland,IRL,1996,2116049,1521461,3637510
Ireland,IRL,1997,2146414,1527757,3674171
Ireland,IRL,1998,2178016,1534680,3712696
Ireland,IRL,1999,2211944,1542842,3754786
Ireland,IRL,2000,2250951,1554223,3805174
Ireland,IRL,2001,2296510,1569733,3866243
Ireland,IRL,2002,2345367,1586580,3931947
Ireland,IRL,2003,2394915,1601606,3996521
Ireland,IRL,2004,2450379,1619883,4070262
Ireland,IRL,2005,2515791,1644123,4159914
Ireland,IRL,2006,2595694,1677897,4273591
Ireland,IRL,2007,2680715,1718227,4398942
Ireland,IRL,2008,2744952,1744592,4489544
Ireland,IRL,2009,2782090,1753285,4535375
Ireland,IRL,2010,2806411,1753744,4560155
Ireland,IRL,2011,2827835,1752249,4580084
Ireland,IRL,2012,2849043,1750490,4599533
Ireland,IRL,2013,2873286,1750530,4623816
Ireland,IRL,2014,2903635,1754105,4657740
Ireland,IRL,2015,2940510,1761447,4701957
Ireland,IRL,2016,2983355,1771980,4755335
Ireland,IRL,2017,3026107,1781281,4807388
Ireland,IRL,2018,3074684,1792632,4867316
Ireland,IRL,2019,3128618,1805722,4934340
Ireland,IRL,2020,3173345,1812037,4985382
Ireland,IRL,2021,3216796,1816369,5033165
Isle of Man,IMN,1960,26896,21897,48793
Isle of Man,IMN,1961,26799,21623,48422
Isle of Man,IMN,1962,27053,21616,48669
Isle of Man,IMN,1963,27428,21703,49131
Isle of Man,IMN,1964,27807,21790,49597
Isle of Man,IMN,1965,28185,21872,50057
Isle of Man,IMN,1966,28640,22078,50718
Isle of Man,IMN,1967,29130,22601,51731
Isle of Man,IMN,1968,29709,23201,52910
Isle of Man,IMN,1969,30291,23808,54099
Isle of Man,IMN,1970,30873,24425,55298
Isle of Man,IMN,1971,31351,25080,56431
Isle of Man,IMN,1972,31448,25971,57419
Isle of Man,IMN,1973,31486,26839,58325
Isle of Man,IMN,1974,31480,27699,59179
Isle of Man,IMN,1975,31415,28534,59949
Isle of Man,IMN,1976,31443,29258,60701
Isle of Man,IMN,1977,31857,29649,61506
Isle of Man,IMN,1978,32283,30050,62333
Isle of Man,IMN,1979,32716,30456,63172
Isle of Man,IMN,1980,33153,30869,64022
Isle of Man,IMN,1981,33428,31130,64558
Isle of Man,IMN,1982,33475,31179,64654
Isle of Man,IMN,1983,33444,31154,64598
Isle of Man,IMN,1984,33391,31109,64500
Isle of Man,IMN,1985,33324,31052,64376
Isle of Man,IMN,1986,33470,31193,64663
Isle of Man,IMN,1987,33929,31625,65554
Isle of Man,IMN,1988,34487,32149,66636
Isle of Man,IMN,1989,35055,32685,67740
Isle of Man,IMN,1990,35635,33230,68865
Isle of Man,IMN,1991,36102,33668,69770
Isle of Man,IMN,1992,36387,33920,70307
Isle of Man,IMN,1993,36602,34108,70710
Isle of Man,IMN,1994,36807,34287,71094
Isle of Man,IMN,1995,37001,34453,71454
Isle of Man,IMN,1996,37280,34701,71981
Isle of Man,IMN,1997,37707,35086,72793
Isle of Man,IMN,1998,38196,35531,73727
Isle of Man,IMN,1999,38689,35979,74668
Isle of Man,IMN,2000,39158,36404,75562
Isle of Man,IMN,2001,39599,36799,76398
Isle of Man,IMN,2002,40020,37163,77183
Isle of Man,IMN,2003,40426,37513,77939
Isle of Man,IMN,2004,40823,37854,78677
Isle of Man,IMN,2005,41220,38195,79415
Isle of Man,IMN,2006,41656,38572,80228
Isle of Man,IMN,2007,42123,38977,81100
Isle of Man,IMN,2008,42604,39393,81997
Isle of Man,IMN,2009,43096,39819,82915
Isle of Man,IMN,2010,43586,40242,83828
Isle of Man,IMN,2011,43872,40478,84350
Isle of Man,IMN,2012,43895,40443,84338
Isle of Man,IMN,2013,43836,40308,84144
Isle of Man,IMN,2014,43762,40134,83896
Isle of Man,IMN,2015,43673,39920,83593
Isle of Man,IMN,2016,43680,39770,83450
Isle of Man,IMN,2017,43844,39736,83580
Isle of Man,IMN,2018,44056,39719,83775
Isle of Man,IMN,2019,44262,39671,83933
Isle of Man,IMN,2020,44459,39587,84046
Isle of Man,IMN,2021,44723,39540,84263
Israel,ISR,1960,1624582,489438,2114020
Israel,ISR,1961,1703972,481028,2185000
Israel,ISR,1962,1805829,487171,2293000
Israel,ISR,1963,1891353,487647,2379000
Israel,ISR,1964,1985742,489258,2475000
Israel,ISR,1965,2074492,488508,2563000
Israel,ISR,1966,2146053,482947,2629000
Israel,ISR,1967,2259135,485865,2745000
Israel,ISR,1968,2325145,477855,2803000
Israel,ISR,1969,2404654,472346,2877000
Israel,ISR,1970,2503959,470041,2974000
Israel,ISR,1971,2602174,466826,3069000
Israel,ISR,1972,2686849,461151,3148000
Israel,ISR,1973,2812295,465705,3278000
Israel,ISR,1974,2911784,465216,3377000
Israel,ISR,1975,2993516,461484,3455000
Israel,ISR,1976,3075582,457418,3533000
Israel,ISR,1977,3159569,453431,3613000
Israel,ISR,1978,3241222,448778,3690000
Israel,ISR,1979,3339820,446180,3786000
Israel,ISR,1980,3435249,442751,3878000
Israel,ISR,1981,3518466,437534,3956000
Israel,ISR,1982,3599159,431841,4031000
Israel,ISR,1983,3678408,426592,4105000
Israel,ISR,1984,3731413,427587,4159000
Israel,ISR,1985,3802419,430581,4233000
Israel,ISR,1986,3866349,432651,4299000
Israel,ISR,1987,3934022,434978,4369000
Israel,ISR,1988,4004463,437537,4442000
Israel,ISR,1989,4077721,440279,4518000
Israel,ISR,1990,4210729,449271,4660000
Israel,ISR,1991,4477014,471986,4949000
Israel,ISR,1992,4639645,483355,5123000
Israel,ISR,1993,4769938,491062,5261000
Israel,ISR,1994,4900510,498490,5399000
Israel,ISR,1995,5038520,506480,5545000
Israel,ISR,1996,5176476,515524,5692000
Israel,ISR,1997,5311285,524715,5836000
Israel,ISR,1998,5438029,532971,5971000
Israel,ISR,1999,5582264,542736,6125000
Israel,ISR,2000,5735757,553243,6289000
Israel,ISR,2001,5876682,562318,6439000
Israel,ISR,2002,6000381,569619,6570000
Israel,ISR,2003,6113918,575782,6689700
Israel,ISR,2004,6227239,581761,6809000
Israel,ISR,2005,6342289,587811,6930100
Israel,ISR,2006,6459778,593922,7053700
Israel,ISR,2007,6579915,600185,7180100
Israel,ISR,2008,6702316,606484,7308800
Israel,ISR,2009,6869011,616589,7485600
Israel,ISR,2010,7000447,623153,7623600
Israel,ISR,2011,7136149,629651,7765800
Israel,ISR,2012,7274496,636004,7910500
Israel,ISR,2013,7417238,642262,8059500
Israel,ISR,2014,7566988,648712,8215700
Israel,ISR,2015,7724692,655408,8380100
Israel,ISR,2016,7884198,661802,8546000
Israel,ISR,2017,8045513,667787,8713300
Israel,ISR,2018,8209306,673494,8882800
Israel,ISR,2019,8375041,678959,9054000
Israel,ISR,2020,8531985,683115,9215100
Israel,ISR,2021,8677993,686007,9364000
Italy,ITA,1960,29799044,20400656,50199700
Italy,ITA,1961,30249038,20287312,50536350
Italy,ITA,1962,30708292,20171158,50879450
Italy,ITA,1963,31188380,20063620,51252000
Italy,ITA,1964,31702827,19972524,51675351
Italy,ITA,1965,32227841,19884508,52112349
Italy,ITA,1966,32737193,19781808,52519001
Italy,ITA,1967,33233152,19667348,52900500
Italy,ITA,1968,33703021,19532728,53235749
Italy,ITA,1969,34152929,19385020,53537949
Italy,ITA,1970,34592379,19229472,53821851
Italy,ITA,1971,35012585,19060904,54073489
Italy,ITA,1972,35369083,19012262,54381345
Italy,ITA,1973,35720365,19031040,54751405
Italy,ITA,1974,36065654,19045214,55110868
Italy,ITA,1975,36393136,19047864,55441000
Italy,ITA,1976,36687131,19031128,55718259
Italy,ITA,1977,36955192,19000220,55955412
Italy,ITA,1978,37198851,18956292,56155143
Italy,ITA,1979,37418639,18899110,56317749
Italy,ITA,1980,37607540,18826344,56433884
Italy,ITA,1981,37764025,18737650,56501675
Italy,ITA,1982,37819718,18723830,56543548
Italy,ITA,1983,37822134,18741940,56564074
Italy,ITA,1984,37819273,18757444,56576717
Italy,ITA,1985,37818886,18774184,56593070
Italy,ITA,1986,37809627,18786528,56596155
Italy,ITA,1987,37802166,18799764,56601930
Italy,ITA,1988,37809110,18820178,56629288
Italy,ITA,1989,37826147,18845634,56671781
Italy,ITA,1990,37846480,18872760,56719240
Italy,ITA,1991,37861339,18897182,56758521
Italy,ITA,1992,37907512,18889576,56797088
Italy,ITA,1993,37964793,18867028,56831821
Italy,ITA,1994,38006634,18836766,56843400
Italy,ITA,1995,38041344,18802960,56844304
Italy,ITA,1996,38086153,18774128,56860281
Italy,ITA,1997,38140443,18749928,56890371
Italy,ITA,1998,38185563,18721180,56906743
Italy,ITA,1999,38226137,18690180,56916317
Italy,ITA,2000,38277624,18664484,56942108
Italy,ITA,2001,38333314,18640786,56974100
Italy,ITA,2002,38447500,18611508,57059008
Italy,ITA,2003,38686985,18626218,57313203
Italy,ITA,2004,39006818,18678508,57685326
Italy,ITA,2005,39267369,18702116,57969485
Italy,ITA,2006,39454178,18689800,58143978
Italy,ITA,2007,39722857,18715452,58438309
Italy,ITA,2008,40056298,18770432,58826730
Italy,ITA,2009,40308358,18787008,59095366
Italy,ITA,2010,40502481,18774936,59277417
Italy,ITA,2011,40641670,18737780,59379450
Italy,ITA,2012,40894259,18645458,59539717
Italy,ITA,2013,41548775,18685172,60233947
Italy,ITA,2014,42109853,18679288,60789141
Italy,ITA,2015,42247229,18483352,60730581
Italy,ITA,2016,42351339,18276160,60627499
Italy,ITA,2017,42462869,18073840,60536709
Italy,ITA,2018,42559879,17861880,60421759
Italy,ITA,2019,42249963,17479118,59729081
Italy,ITA,2020,42224765,17214086,59438851
Italy,ITA,2021,42172384,16937284,59109668
Jamaica,JAM,1960,554599,1087732,1642331
Jamaica,JAM,1961,573995,1089759,1663754
Jamaica,JAM,1962,593341,1090420,1683761
Jamaica,JAM,1963,613137,1090731,1703868
Jamaica,JAM,1964,633831,1091350,1725181
Jamaica,JAM,1965,655099,1091878,1746977
Jamaica,JAM,1966,676832,1091971,1768803
Jamaica,JAM,1967,698971,1091609,1790580
Jamaica,JAM,1968,721531,1090678,1812209
Jamaica,JAM,1969,744780,1089835,1834615
Jamaica,JAM,1970,768251,1090840,1859091
Jamaica,JAM,1971,789502,1096641,1886143
Jamaica,JAM,1972,811991,1103308,1915299
Jamaica,JAM,1973,835184,1110136,1945320
Jamaica,JAM,1974,858520,1116360,1974880
Jamaica,JAM,1975,881622,1121472,2003094
Jamaica,JAM,1976,904278,1125208,2029486
Jamaica,JAM,1977,926772,1128155,2054927
Jamaica,JAM,1978,949637,1130848,2080485
Jamaica,JAM,1979,973215,1133722,2106937
Jamaica,JAM,1980,998133,1137413,2135546
Jamaica,JAM,1981,1024525,1142132,2166657
Jamaica,JAM,1982,1051698,1147908,2199606
Jamaica,JAM,1983,1072093,1160689,2232782
Jamaica,JAM,1984,1091747,1172348,2264095
Jamaica,JAM,1985,1109893,1182137,2292030
Jamaica,JAM,1986,1126162,1189709,2315871
Jamaica,JAM,1987,1140835,1195410,2336245
Jamaica,JAM,1988,1154702,1200103,2354805
Jamaica,JAM,1989,1168645,1204720,2373365
Jamaica,JAM,1990,1182715,1209315,2392030
Jamaica,JAM,1991,1197637,1214230,2411867
Jamaica,JAM,1992,1214755,1219819,2434574
Jamaica,JAM,1993,1232875,1226187,2459062
Jamaica,JAM,1994,1251407,1232775,2484182
Jamaica,JAM,1995,1270119,1239253,2509372
Jamaica,JAM,1996,1288103,1244791,2532894
Jamaica,JAM,1997,1305454,1249500,2554954
Jamaica,JAM,1998,1322681,1253886,2576567
Jamaica,JAM,1999,1339001,1257270,2596271
Jamaica,JAM,2000,1353488,1258717,2612205
Jamaica,JAM,2001,1366602,1258803,2625405
Jamaica,JAM,2002,1378509,1259735,2638244
Jamaica,JAM,2003,1390119,1260908,2651027
Jamaica,JAM,2004,1401943,1262081,2664024
Jamaica,JAM,2005,1413678,1263185,2676863
Jamaica,JAM,2006,1425466,1264194,2689660
Jamaica,JAM,2007,1436617,1264604,2701221
Jamaica,JAM,2008,1447087,1264286,2711373
Jamaica,JAM,2009,1458036,1264365,2722401
Jamaica,JAM,2010,1469278,1264618,2733896
Jamaica,JAM,2011,1481009,1265160,2746169
Jamaica,JAM,2012,1493944,1265873,2759817
Jamaica,JAM,2013,1507196,1265933,2773129
Jamaica,JAM,2014,1519915,1264628,2784543
Jamaica,JAM,2015,1532278,1262167,2794445
Jamaica,JAM,2016,1544229,1258466,2802695
Jamaica,JAM,2017,1555222,1253154,2808376
Jamaica,JAM,2018,1565461,1246374,2811835
Jamaica,JAM,2019,1575291,1238482,2813773
Jamaica,JAM,2020,1588216,1232220,2820436
Jamaica,JAM,2021,1601946,1225749,2827695
Japan,JPN,1960,58979628,34236372,93216000
Japan,JPN,1961,60395537,33659464,94055001
Japan,JPN,1962,61843154,33089846,94933000
Japan,JPN,1963,63355376,32544624,95900000
Japan,JPN,1964,64897877,32005124,96903001
Japan,JPN,1965,66476104,31475896,97952000
Japan,JPN,1966,67914591,30936408,98850999
Japan,JPN,1967,69431886,30447114,99879000
Japan,JPN,1968,71026895,29984104,101010999
Japan,JPN,1969,72679753,29539248,102219001
Japan,JPN,1970,74322974,29080026,103403000
Japan,JPN,1971,76805782,28891218,105697000
Japan,JPN,1972,78731730,28456270,107188000
Japan,JPN,1973,80682335,28024664,108706999
Japan,JPN,1974,82593959,27568040,110161999
Japan,JPN,1975,84478613,27094388,111573001
Japan,JPN,1976,85645846,27129154,112775000
Japan,JPN,1977,86544997,27327004,113872001
Japan,JPN,1978,87402828,27510172,114913000
Japan,JPN,1979,88213150,27676850,115890000
Japan,JPN,1980,88977732,27829268,116807000
Japan,JPN,1981,89743575,27917424,117660999
Japan,JPN,1982,90498578,27981422,118480000
Japan,JPN,1983,91261504,28045496,119307000
Japan,JPN,1984,91987180,28095820,120083000
Japan,JPN,1985,92696479,28140520,120836999
Japan,JPN,1986,93340695,28141304,121481999
Japan,JPN,1987,93946744,28122256,122069000
Japan,JPN,1988,94492929,28085072,122578001
Japan,JPN,1989,95025267,28043732,123068999
Japan,JPN,1990,95496650,27981350,123478000
Japan,JPN,1991,96038630,27925370,123964000
Japan,JPN,1992,96566243,27858756,124424999
Japan,JPN,1993,97049554,27779446,124829000
Japan,JPN,1994,97489878,27688122,125178000
Japan,JPN,1995,97888236,27583764,125472000
Japan,JPN,1996,98272808,27484192,125757000
Japan,JPN,1997,98667335,27389664,126056999
Japan,JPN,1998,99095072,27304928,126400000
Japan,JPN,1999,99434460,27196540,126631000
Japan,JPN,2000,99760751,27082248,126842999
Japan,JPN,2001,101706485,25442516,127149001
Japan,JPN,2002,104055019,23389980,127444999
Japan,JPN,2003,106256267,21461732,127717999
Japan,JPN,2004,108136910,19624090,127761000
Japan,JPN,2005,109856670,17916330,127773000
Japan,JPN,2006,111383848,16470152,127854000
Japan,JPN,2007,112827761,15173239,128001000
Japan,JPN,2008,114107975,13955025,128063000
Japan,JPN,2009,115228215,12818785,128047000
Japan,JPN,2010,116302928,11767072,128070000
Japan,JPN,2011,116416235,11416765,127833000
Japan,JPN,2012,116331281,11297719,127629000
Japan,JPN,2013,116262976,11182024,127445000
Japan,JPN,2014,116208079,11067921,127276000
Japan,JPN,2015,116182717,10958283,127141000
Japan,JPN,2016,116219897,10856103,127076000
Japan,JPN,2017,116223820,10748180,126972000
Japan,JPN,2018,116179166,10631834,126811000
Japan,JPN,2019,116119928,10513072,126633000
Japan,JPN,2020,115884871,10376129,126261000
Japan,JPN,2021,115459909,10221684,125681593
Jordan,JOR,1960,431421,416515,847936
Jordan,JOR,1961,467435,424413,891848
Jordan,JOR,1962,497355,437260,934615
Jordan,JOR,1963,524191,454416,978607
Jordan,JOR,1964,555016,474431,1029447
Jordan,JOR,1965,593341,500133,1093474
Jordan,JOR,1966,640450,532320,1172770
Jordan,JOR,1967,695580,570100,1265680
Jordan,JOR,1968,755699,610945,1366644
Jordan,JOR,1969,815818,650610,1466428
Jordan,JOR,1970,871678,685696,1557374
Jordan,JOR,1971,921379,714941,1636320
Jordan,JOR,1972,965677,739110,1704787
Jordan,JOR,1973,1007072,760342,1767414
Jordan,JOR,1974,1047480,780104,1827584
Jordan,JOR,1975,1087646,798990,1886636
Jordan,JOR,1976,1127871,817270,1945141
Jordan,JOR,1977,1169480,835938,2005418
Jordan,JOR,1978,1213509,855595,2069104
Jordan,JOR,1979,1261038,877040,2138078
Jordan,JOR,1980,1330785,886118,2216903
Jordan,JOR,1981,1417762,888893,2306655
Jordan,JOR,1982,1513160,893189,2406349
Jordan,JOR,1983,1616454,898331,2514785
Jordan,JOR,1984,1726608,903331,2629939
Jordan,JOR,1985,1843390,908102,2751492
Jordan,JOR,1986,1967335,912464,2879799
Jordan,JOR,1987,2098408,916286,3014694
Jordan,JOR,1988,2237428,919749,3157177
Jordan,JOR,1989,2387032,923922,3310954
Jordan,JOR,1990,2550957,929630,3480587
Jordan,JOR,1991,2729802,936577,3666379
Jordan,JOR,1992,2922825,944062,3866887
Jordan,JOR,1993,3125292,950467,4075759
Jordan,JOR,1994,3325846,952320,4278166
Jordan,JOR,1995,3486621,971574,4458195
Jordan,JOR,1996,3604906,1003770,4608676
Jordan,JOR,1997,3703241,1030424,4733665
Jordan,JOR,1998,3790503,1053900,4844403
Jordan,JOR,1999,3874377,1076398,4950775
Jordan,JOR,2000,3957467,1098707,5056174
Jordan,JOR,2001,4041994,1121316,5163310
Jordan,JOR,2002,4130531,1145001,5275532
Jordan,JOR,2003,4225591,1170526,5396117
Jordan,JOR,2004,4333049,1199374,5532423
Jordan,JOR,2005,4513583,1164951,5678534
Jordan,JOR,2006,4919371,1156177,6075548
Jordan,JOR,2007,5332251,1141206,6473457
Jordan,JOR,2008,5551184,1081689,6632873
Jordan,JOR,2009,5758537,1021956,6780493
Jordan,JOR,2010,5966981,964277,6931258
Jordan,JOR,2011,6197912,912068,7109980
Jordan,JOR,2012,6359781,852082,7211863
Jordan,JOR,2013,6858003,836811,7694814
Jordan,JOR,2014,7792223,865803,8658026
Jordan,JOR,2015,8569127,925119,9494246
Jordan,JOR,2016,9018612,946044,9964656
Jordan,JOR,2017,9270152,945229,10215381
Jordan,JOR,2018,9516281,943584,10459865
Jordan,JOR,2019,9757520,941163,10698683
Jordan,JOR,2020,9990818,937903,10928721
Jordan,JOR,2021,10214721,933557,11148278
Kazakhstan,KAZ,1960,4118937,5200346,9319283
Kazakhstan,KAZ,1961,4313202,5326100,9639302
Kazakhstan,KAZ,1962,4511216,5448198,9959414
Kazakhstan,KAZ,1963,4712058,5565732,10277790
Kazakhstan,KAZ,1964,4914193,5676741,10590934
Kazakhstan,KAZ,1965,5127015,5770629,10897644
Kazakhstan,KAZ,1966,5340792,5856776,11197568
Kazakhstan,KAZ,1967,5555549,5935679,11491228
Kazakhstan,KAZ,1968,5770793,6007056,11777849
Kazakhstan,KAZ,1969,5978729,6063749,12042478
Kazakhstan,KAZ,1970,6161599,6103706,12265305
Kazakhstan,KAZ,1971,6315875,6128463,12444338
Kazakhstan,KAZ,1972,6466045,6145952,12611997
Kazakhstan,KAZ,1973,6623294,6166691,12789985
Kazakhstan,KAZ,1974,6784616,6187881,12972497
Kazakhstan,KAZ,1975,6916866,6242076,13158942
Kazakhstan,KAZ,1976,7050516,6295657,13346173
Kazakhstan,KAZ,1977,7190526,6352995,13543521
Kazakhstan,KAZ,1978,7336605,6413686,13750291
Kazakhstan,KAZ,1979,7495336,6462459,13957795
Kazakhstan,KAZ,1980,7673389,6499321,14172710
Kazakhstan,KAZ,1981,7858384,6539007,14397391
Kazakhstan,KAZ,1982,8052018,6582161,14634179
Kazakhstan,KAZ,1983,8255906,6630060,14885966
Kazakhstan,KAZ,1984,8467503,6680087,15147590
Kazakhstan,KAZ,1985,8632998,6780317,15413315
Kazakhstan,KAZ,1986,8822945,6898344,15721289
Kazakhstan,KAZ,1987,9037715,7034763,16072478
Kazakhstan,KAZ,1988,9257159,7173431,16430590
Kazakhstan,KAZ,1989,9157731,7091769,16249500
Kazakhstan,KAZ,1990,9198366,7149634,16348000
Kazakhstan,KAZ,1991,9241749,7209962,16451711
Kazakhstan,KAZ,1992,9219538,7219557,16439095
Kazakhstan,KAZ,1993,9171866,7208806,16380672
Kazakhstan,KAZ,1994,9025483,7120283,16145766
Kazakhstan,KAZ,1995,8844601,6971642,15816243
Kazakhstan,KAZ,1996,8714928,6863299,15578227
Kazakhstan,KAZ,1997,8581746,6752659,15334405
Kazakhstan,KAZ,1998,8438008,6633632,15071640
Kazakhstan,KAZ,1999,8363622,6564752,14928374
Kazakhstan,KAZ,2000,8349417,6534209,14883626
Kazakhstan,KAZ,2001,8346075,6512260,14858335
Kazakhstan,KAZ,2002,8357267,6501681,14858948
Kazakhstan,KAZ,2003,8396312,6512707,14909019
Kazakhstan,KAZ,2004,8465822,6547162,15012984
Kazakhstan,KAZ,2005,8552467,6594562,15147029
Kazakhstan,KAZ,2006,8654579,6653506,15308085
Kazakhstan,KAZ,2007,8765446,6718746,15484192
Kazakhstan,KAZ,2008,8942684,6834254,15776938
Kazakhstan,KAZ,2009,9133481,6959341,16092822
Kazakhstan,KAZ,2010,9275230,7046642,16321872
Kazakhstan,KAZ,2011,9421048,7136154,16557202
Kazakhstan,KAZ,2012,9566957,7225133,16792090
Kazakhstan,KAZ,2013,9718100,7317451,17035551
Kazakhstan,KAZ,2014,9874723,7413562,17288285
Kazakhstan,KAZ,2015,10032906,7509900,17542806
Kazakhstan,KAZ,2016,10189588,7604467,17794055
Kazakhstan,KAZ,2017,10342139,7695637,18037776
Kazakhstan,KAZ,2018,10495801,7780651,18276452
Kazakhstan,KAZ,2019,10652767,7860906,18513673
Kazakhstan,KAZ,2020,10816580,7939086,18755666
Kazakhstan,KAZ,2021,10986561,8014427,19000988
Kenya,KEN,1960,570661,7180774,7751435
Kenya,KEN,1961,608791,7438679,8047470
Kenya,KEN,1962,650185,7713393,8363578
Kenya,KEN,1963,699081,7998119,8697200
Kenya,KEN,1964,752562,8294825,9047387
Kenya,KEN,1965,810351,8606856,9417207
Kenya,KEN,1966,872628,8929977,9802605
Kenya,KEN,1967,939416,9261652,10201068
Kenya,KEN,1968,1010972,9602905,10613877
Kenya,KEN,1969,1087396,9952155,11039551
Kenya,KEN,1970,1181154,10291933,11473087
Kenya,KEN,1971,1282416,10616041,11898457
Kenya,KEN,1972,1390270,10932633,12322903
Kenya,KEN,1973,1506366,11254039,12760405
Kenya,KEN,1974,1630556,11573393,13203949
Kenya,KEN,1975,1763007,11888901,13651908
Kenya,KEN,1976,1904229,12198039,14102268
Kenya,KEN,1977,2057155,12520191,14577346
Kenya,KEN,1978,2224641,12862782,15087423
Kenya,KEN,1979,2405731,13214882,15620613
Kenya,KEN,1980,2522440,13664684,16187124
Kenya,KEN,1981,2632207,14153755,16785962
Kenya,KEN,1982,2747533,14663958,17411491
Kenya,KEN,1983,2869250,15200211,18069461
Kenya,KEN,1984,2996570,15756606,18753176
Kenya,KEN,1985,3127713,16324448,19452161
Kenya,KEN,1986,3262030,16898848,20160878
Kenya,KEN,1987,3399814,17482280,20882094
Kenya,KEN,1988,3543008,18083114,21626122
Kenya,KEN,1989,3690629,18697174,22387803
Kenya,KEN,1990,3879217,19283052,23162269
Kenya,KEN,1991,4076385,19841850,23918235
Kenya,KEN,1992,4275795,20379928,24655723
Kenya,KEN,1993,4480388,20911442,25391830
Kenya,KEN,1994,4691530,21442214,26133744
Kenya,KEN,1995,4908793,21969554,26878347
Kenya,KEN,1996,5130728,22485008,27615736
Kenya,KEN,1997,5360279,23003984,28364263
Kenya,KEN,1998,5600786,23536588,29137374
Kenya,KEN,1999,5858183,24106946,29965129
Kenya,KEN,2000,6137001,24714604,30851605
Kenya,KEN,2001,6436071,25364272,31800343
Kenya,KEN,2002,6749693,26030130,32779823
Kenya,KEN,2003,7073537,26693584,33767121
Kenya,KEN,2004,7414140,27377696,34791836
Kenya,KEN,2005,7768972,28074038,35843010
Kenya,KEN,2006,8140172,28785080,36925252
Kenya,KEN,2007,8527849,29508944,38036793
Kenya,KEN,2008,8934612,30252284,39186896
Kenya,KEN,2009,9357689,31006756,40364445
Kenya,KEN,2010,9786183,31731712,41517895
Kenya,KEN,2011,10219218,32415926,42635144
Kenya,KEN,2012,10658602,33067204,43725806
Kenya,KEN,2013,11105820,33686548,44792368
Kenya,KEN,2014,11559254,34272610,45831864
Kenya,KEN,2015,12021155,34830332,46851487
Kenya,KEN,2016,12502904,35391770,47894674
Kenya,KEN,2017,13001604,35946532,48948136
Kenya,KEN,2018,13502378,36450930,49953308
Kenya,KEN,2019,14015215,36936236,50951451
Kenya,KEN,2020,14553419,37432360,51985779
Kenya,KEN,2021,15102890,37902724,53005614
Kiribati,KIR,1960,7671,39422,47093
Kiribati,KIR,1961,8167,40108,48275
Kiribati,KIR,1962,8697,40811,49508
Kiribati,KIR,1963,9259,41521,50780
Kiribati,KIR,1964,9856,42236,52092
Kiribati,KIR,1965,10488,42956,53444
Kiribati,KIR,1966,11077,43351,54428
Kiribati,KIR,1967,11601,43389,54990
Kiribati,KIR,1968,12136,43375,55511
Kiribati,KIR,1969,12882,43442,56324
Kiribati,KIR,1970,13835,43602,57437
Kiribati,KIR,1971,14837,43698,58535
Kiribati,KIR,1972,15887,43719,59606
Kiribati,KIR,1973,16966,43632,60598
Kiribati,KIR,1974,17652,43301,60953
Kiribati,KIR,1975,17963,42712,60675
Kiribati,KIR,1976,18251,42059,60310
Kiribati,KIR,1977,18522,41372,59894
Kiribati,KIR,1978,18789,40676,59465
Kiribati,KIR,1979,19150,40625,59775
Kiribati,KIR,1980,19633,41180,60813
Kiribati,KIR,1981,20129,41746,61875
Kiribati,KIR,1982,20645,42332,62977
Kiribati,KIR,1983,21180,42941,64121
Kiribati,KIR,1984,21747,43591,65338
Kiribati,KIR,1985,22375,44333,66708
Kiribati,KIR,1986,23093,45173,68266
Kiribati,KIR,1987,23863,46083,69946
Kiribati,KIR,1988,24662,47018,71680
Kiribati,KIR,1989,25479,47957,73436
Kiribati,KIR,1990,26284,48840,75124
Kiribati,KIR,1991,27023,49589,76612
Kiribati,KIR,1992,27698,50203,77901
Kiribati,KIR,1993,28346,50747,79093
Kiribati,KIR,1994,28994,51270,80264
Kiribati,KIR,1995,29666,51815,81481
Kiribati,KIR,1996,30968,51864,82832
Kiribati,KIR,1997,32671,51637,84308
Kiribati,KIR,1998,34440,51365,85805
Kiribati,KIR,1999,36260,51029,87289
Kiribati,KIR,2000,38158,50668,88826
Kiribati,KIR,2001,39357,51174,90531
Kiribati,KIR,2002,40187,52213,92400
Kiribati,KIR,2003,41033,53269,94302
Kiribati,KIR,2004,41888,54336,96224
Kiribati,KIR,2005,42751,55413,98164
Kiribati,KIR,2006,44067,56016,100083
Kiribati,KIR,2007,45762,56236,101998
Kiribati,KIR,2008,47519,56447,103966
Kiribati,KIR,2009,49338,56658,105996
Kiribati,KIR,2010,51179,56816,107995
Kiribati,KIR,2011,52996,56875,109871
Kiribati,KIR,2012,54784,56834,111618
Kiribati,KIR,2013,56573,56738,113311
Kiribati,KIR,2014,58381,56604,114985
Kiribati,KIR,2015,60243,56464,116707
Kiribati,KIR,2016,62160,56353,118513
Kiribati,KIR,2017,64107,56255,120362
Kiribati,KIR,2018,66091,56170,122261
Kiribati,KIR,2019,68128,56113,124241
Kiribati,KIR,2020,70306,56157,126463
Kiribati,KIR,2021,72601,56273,128874
Kuwait,KWT,1960,228734,76681,305415
Kuwait,KWT,1961,257446,82251,339697
Kuwait,KWT,1962,289920,88270,378190
Kuwait,KWT,1963,325929,94565,420494
Kuwait,KWT,1964,364872,100876,465748
Kuwait,KWT,1965,407336,106504,513840
Kuwait,KWT,1966,456419,109044,565463
Kuwait,KWT,1967,509922,111320,621242
Kuwait,KWT,1968,567854,113263,681117
Kuwait,KWT,1969,628481,114563,743044
Kuwait,KWT,1970,687675,115111,802786
Kuwait,KWT,1971,742324,116410,858734
Kuwait,KWT,1972,796747,117038,913785
Kuwait,KWT,1973,853113,117414,970527
Kuwait,KWT,1974,912741,117685,1030426
Kuwait,KWT,1975,979647,116351,1095998
Kuwait,KWT,1976,1060619,108172,1168791
Kuwait,KWT,1977,1146749,100476,1247225
Kuwait,KWT,1978,1236039,93035,1329074
Kuwait,KWT,1979,1326513,85753,1412266
Kuwait,KWT,1980,1415905,77965,1493870
Kuwait,KWT,1981,1504914,68112,1573026
Kuwait,KWT,1982,1593647,59274,1652921
Kuwait,KWT,1983,1684537,51491,1736028
Kuwait,KWT,1984,1769561,44425,1813986
Kuwait,KWT,1985,1849363,39612,1888975
Kuwait,KWT,1986,1927098,40995,1968093
Kuwait,KWT,1987,2006114,42363,2048477
Kuwait,KWT,1988,2085420,43733,2129153
Kuwait,KWT,1989,2164929,45084,2210013
Kuwait,KWT,1990,1641004,33934,1674938
Kuwait,KWT,1991,1312549,26951,1339500
Kuwait,KWT,1992,1588253,32380,1620633
Kuwait,KWT,1993,1620837,32808,1653645
Kuwait,KWT,1994,1608760,32346,1641106
Kuwait,KWT,1995,1623707,31515,1655222
Kuwait,KWT,1996,1674787,28531,1703318
Kuwait,KWT,1997,1735522,25946,1761468
Kuwait,KWT,1998,1795981,23563,1819544
Kuwait,KWT,1999,1856062,21365,1877427
Kuwait,KWT,2000,1915552,19349,1934901
Kuwait,KWT,2001,1989842,1832,1991674
Kuwait,KWT,2002,2047364,0,2047364
Kuwait,KWT,2003,2101506,0,2101506
Kuwait,KWT,2004,2153481,0,2153481
Kuwait,KWT,2005,2235403,0,2235403
Kuwait,KWT,2006,2363409,0,2363409
Kuwait,KWT,2007,2506769,0,2506769
Kuwait,KWT,2008,2650930,0,2650930
Kuwait,KWT,2009,2795550,0,2795550
Kuwait,KWT,2010,2943356,0,2943356
Kuwait,KWT,2011,3143825,0,3143825
Kuwait,KWT,2012,3394663,0,3394663
Kuwait,KWT,2013,3646518,0,3646518
Kuwait,KWT,2014,3761584,0,3761584
Kuwait,KWT,2015,3908743,0,3908743
Kuwait,KWT,2016,4048085,0,4048085
Kuwait,KWT,2017,4124904,0,4124904
Kuwait,KWT,2018,4317185,0,4317185
Kuwait,KWT,2019,4441100,0,4441100
Kuwait,KWT,2020,4360444,0,4360444
Kuwait,KWT,2021,4250114,0,4250114
Kyrgyzstan,KGZ,1960,742514,1429786,2172300
Kyrgyzstan,KGZ,1961,778534,1477366,2255900
Kyrgyzstan,KGZ,1962,813050,1520350,2333400
Kyrgyzstan,KGZ,1963,849091,1564609,2413700
Kyrgyzstan,KGZ,1964,886206,1609094,2495300
Kyrgyzstan,KGZ,1965,922554,1650746,2573300
Kyrgyzstan,KGZ,1966,960953,1694347,2655300
Kyrgyzstan,KGZ,1967,999643,1736857,2736500
Kyrgyzstan,KGZ,1968,1039135,1779165,2818300
Kyrgyzstan,KGZ,1969,1077271,1817529,2894800
Kyrgyzstan,KGZ,1970,1108956,1850944,2959900
Kyrgyzstan,KGZ,1971,1136657,1885643,3022300
Kyrgyzstan,KGZ,1972,1165888,1922312,3088200
Kyrgyzstan,KGZ,1973,1195196,1958604,3153800
Kyrgyzstan,KGZ,1974,1226436,1997464,3223900
Kyrgyzstan,KGZ,1975,1257236,2035164,3292400
Kyrgyzstan,KGZ,1976,1287423,2071277,3358700
Kyrgyzstan,KGZ,1977,1317380,2106520,3423900
Kyrgyzstan,KGZ,1978,1346753,2140347,3487100
Kyrgyzstan,KGZ,1979,1373807,2178193,3552000
Kyrgyzstan,KGZ,1980,1397293,2220107,3617400
Kyrgyzstan,KGZ,1981,1421871,2263929,3685800
Kyrgyzstan,KGZ,1982,1448346,2310954,3759300
Kyrgyzstan,KGZ,1983,1476863,2361437,3838300
Kyrgyzstan,KGZ,1984,1504955,2411445,3916400
Kyrgyzstan,KGZ,1985,1531357,2458943,3990300
Kyrgyzstan,KGZ,1986,1558567,2507933,4066500
Kyrgyzstan,KGZ,1987,1586429,2558171,4144600
Kyrgyzstan,KGZ,1988,1612568,2605832,4218400
Kyrgyzstan,KGZ,1989,1639650,2667850,4307500
Kyrgyzstan,KGZ,1990,1658864,2732336,4391200
Kyrgyzstan,KGZ,1991,1673404,2790196,4463600
Kyrgyzstan,KGZ,1992,1679864,2835536,4515400
Kyrgyzstan,KGZ,1993,1667475,2849225,4516700
Kyrgyzstan,KGZ,1994,1654017,2861083,4515100
Kyrgyzstan,KGZ,1995,1657660,2902740,4560400
Kyrgyzstan,KGZ,1996,1669279,2959121,4628400
Kyrgyzstan,KGZ,1997,1680607,3015793,4696400
Kyrgyzstan,KGZ,1998,1693186,3075814,4769000
Kyrgyzstan,KGZ,1999,1708661,3131739,4840400
Kyrgyzstan,KGZ,2000,1729037,3169363,4898400
Kyrgyzstan,KGZ,2001,1745422,3199678,4945100
Kyrgyzstan,KGZ,2002,1761468,3229232,4990700
Kyrgyzstan,KGZ,2003,1779932,3263368,5043300
Kyrgyzstan,KGZ,2004,1801551,3303149,5104700
Kyrgyzstan,KGZ,2005,1821882,3340718,5162600
Kyrgyzstan,KGZ,2006,1841521,3376879,5218400
Kyrgyzstan,KGZ,2007,1859060,3409340,5268400
Kyrgyzstan,KGZ,2008,1876703,3441997,5318700
Kyrgyzstan,KGZ,2009,1899444,3483856,5383300
Kyrgyzstan,KGZ,2010,1923436,3524464,5447900
Kyrgyzstan,KGZ,2011,1949521,3565079,5514600
Kyrgyzstan,KGZ,2012,1986238,3620962,5607200
Kyrgyzstan,KGZ,2013,2031430,3688170,5719600
Kyrgyzstan,KGZ,2014,2079480,3756020,5835500
Kyrgyzstan,KGZ,2015,2131200,3825700,5956900
Kyrgyzstan,KGZ,2016,2185215,3894285,6079500
Kyrgyzstan,KGZ,2017,2239720,3958480,6198200
Kyrgyzstan,KGZ,2018,2298401,4024399,6322800
Kyrgyzstan,KGZ,2019,2362388,4093812,6456200
Kyrgyzstan,KGZ,2020,2425088,4154812,6579900
Kyrgyzstan,KGZ,2021,2485736,4206064,6691800
Laos,LAO,1960,168656,1953876,2122532
Laos,LAO,1961,174126,1997015,2171141
Laos,LAO,1962,179840,2041775,2221615
Laos,LAO,1963,185722,2087497,2273219
Laos,LAO,1964,191762,2133751,2325513
Laos,LAO,1965,198042,2181414,2379456
Laos,LAO,1966,204528,2230333,2434861
Laos,LAO,1967,216598,2275329,2491927
Laos,LAO,1968,229443,2321627,2551070
Laos,LAO,1969,243031,2369080,2612111
Laos,LAO,1970,257496,2417787,2675283
Laos,LAO,1971,272840,2467892,2740732
Laos,LAO,1972,289113,2519177,2808290
Laos,LAO,1973,304935,2572626,2877561
Laos,LAO,1974,319354,2627528,2946882
Laos,LAO,1975,333840,2678880,3012720
Laos,LAO,1976,348090,2723927,3072017
Laos,LAO,1977,362086,2763656,3125742
Laos,LAO,1978,376364,2801581,3177945
Laos,LAO,1979,391504,2842196,3233700
Laos,LAO,1980,408134,2889385,3297519
Laos,LAO,1981,426431,2944562,3370993
Laos,LAO,1982,446562,3007129,3453691
Laos,LAO,1983,468286,3075575,3543861
Laos,LAO,1984,491540,3148416,3639956
Laos,LAO,1985,516491,3225113,3741604
Laos,LAO,1986,543316,3305074,3848390
Laos,LAO,1987,571741,3387956,3959697
Laos,LAO,1988,601709,3473252,4074961
Laos,LAO,1989,633139,3560393,4193532
Laos,LAO,1990,666021,3648422,4314443
Laos,LAO,1991,700283,3736942,4437225
Laos,LAO,1992,735843,3825263,4561106
Laos,LAO,1993,772605,3912691,4685296
Laos,LAO,1994,810332,3997618,4807950
Laos,LAO,1995,856289,4071143,4927432
Laos,LAO,1996,919707,4124207,5043914
Laos,LAO,1997,984783,4165755,5150538
Laos,LAO,1998,1051431,4195491,5246922
Laos,LAO,1999,1120931,4219125,5340056
Laos,LAO,2000,1193539,4237314,5430853
Laos,LAO,2001,1269146,4250561,5519707
Laos,LAO,2002,1347931,4258170,5606101
Laos,LAO,2003,1429434,4259631,5689065
Laos,LAO,2004,1513682,4254485,5768167
Laos,LAO,2005,1591188,4261782,5852970
Laos,LAO,2006,1650061,4296532,5946593
Laos,LAO,2007,1710668,4330680,6041348
Laos,LAO,2008,1772834,4363027,6135861
Laos,LAO,2009,1836272,4393658,6229930
Laos,LAO,2010,1901072,4422346,6323418
Laos,LAO,2011,1967246,4449081,6416327
Laos,LAO,2012,2034912,4473891,6508803
Laos,LAO,2013,2103788,4496954,6600742
Laos,LAO,2014,2173853,4517601,6691454
Laos,LAO,2015,2247179,4540240,6787419
Laos,LAO,2016,2324870,4566493,6891363
Laos,LAO,2017,2405044,4592873,6997917
Laos,LAO,2018,2487036,4617970,7105006
Laos,LAO,2019,2570736,4641317,7212053
Laos,LAO,2020,2656210,4663189,7319399
Laos,LAO,2021,2742742,4682315,7425057
Latin America and Caribbean (WB),,1960,108291516,110846980,219138496
Latin America and Caribbean (WB),,1961,113140419,112159940,225300359
Latin America and Caribbean (WB),,1962,118204913,113429240,231634153
Latin America and Caribbean (WB),,1963,123460573,114662830,238123403
Latin America and Caribbean (WB),,1964,128899768,115837624,244737392
Latin America and Caribbean (WB),,1965,134364759,117088590,251453349
Latin America and Caribbean (WB),,1966,139959463,118260760,258220223
Latin America and Caribbean (WB),,1967,145676325,119348540,265024865
Latin America and Caribbean (WB),,1968,151528157,120352050,271880207
Latin America and Caribbean (WB),,1969,157504259,121287640,278791899
Latin America and Caribbean (WB),,1970,163608217,122164990,285773207
Latin America and Caribbean (WB),,1971,169887008,122959950,292846958
Latin America and Caribbean (WB),,1972,176317131,123712870,300030001
Latin America and Caribbean (WB),,1973,182861279,124477640,307338919
Latin America and Caribbean (WB),,1974,189558873,125194440,314753313
Latin America and Caribbean (WB),,1975,196407877,125834570,322242447
Latin America and Caribbean (WB),,1976,203394605,126406130,329800735
Latin America and Caribbean (WB),,1977,210593144,126931240,337524384
Latin America and Caribbean (WB),,1978,218018969,127424440,345443409
Latin America and Caribbean (WB),,1979,225586410,127858220,353444630
Latin America and Caribbean (WB),,1980,233258489,128184910,361443399
Latin America and Caribbean (WB),,1981,240895000,128418330,369313330
Latin America and Caribbean (WB),,1982,248510846,128670070,377180916
Latin America and Caribbean (WB),,1983,256236133,128942776,385178909
Latin America and Caribbean (WB),,1984,264057385,129156430,393213815
Latin America and Caribbean (WB),,1985,271940828,129295190,401236018
Latin America and Caribbean (WB),,1986,279848185,129392630,409240815
Latin America and Caribbean (WB),,1987,287800092,129445350,417245442
Latin America and Caribbean (WB),,1988,295841710,129455180,425296890
Latin America and Caribbean (WB),,1989,303940453,129426936,433367389
Latin America and Caribbean (WB),,1990,312157472,129411930,441569402
Latin America and Caribbean (WB),,1991,320338755,129480140,449818895
Latin America and Caribbean (WB),,1992,328437425,129541620,457979045
Latin America and Caribbean (WB),,1993,336541527,129568290,466109817
Latin America and Caribbean (WB),,1994,344746561,129482850,474229411
Latin America and Caribbean (WB),,1995,352973775,129328080,482301855
Latin America and Caribbean (WB),,1996,361099246,129175410,490274656
Latin America and Caribbean (WB),,1997,369285722,128884360,498170082
Latin America and Caribbean (WB),,1998,377457821,128523640,505981461
Latin America and Caribbean (WB),,1999,385538315,128146990,513685305
Latin America and Caribbean (WB),,2000,393557252,127694290,521251542
Latin America and Caribbean (WB),,2001,401043709,127614184,528657893
Latin America and Caribbean (WB),,2002,408305152,127599230,535904382
Latin America and Caribbean (WB),,2003,415412489,127532136,542944625
Latin America and Caribbean (WB),,2004,422401468,127463470,549864938
Latin America and Caribbean (WB),,2005,429345391,127360690,556706081
Latin America and Caribbean (WB),,2006,436193125,127196810,563389935
Latin America and Caribbean (WB),,2007,442953513,126983820,569937333
Latin America and Caribbean (WB),,2008,449611195,126739440,576350635
Latin America and Caribbean (WB),,2009,456215612,126486340,582701952
Latin America and Caribbean (WB),,2010,462643953,126193450,588837403
Latin America and Caribbean (WB),,2011,469524671,125948984,595473655
Latin America and Caribbean (WB),,2012,476387252,125716120,602103372
Latin America and Caribbean (WB),,2013,483150473,125456130,608606603
Latin America and Caribbean (WB),,2014,489854175,125157320,615011495
Latin America and Caribbean (WB),,2015,496525353,124829736,621355089
Latin America and Caribbean (WB),,2016,503147437,124486220,627633657
Latin America and Caribbean (WB),,2017,509636804,124125890,633762694
Latin America and Caribbean (WB),,2018,515837393,123756984,639594377
Latin America and Caribbean (WB),,2019,521945599,123317090,645262689
Latin America and Caribbean (WB),,2020,527782335,122720080,650502415
Latin America and Caribbean (WB),,2021,532978690,121971064,654949754
Latvia,LVA,1960,1121298,999681,2120979
Latvia,LVA,1961,1155193,997488,2152681
Latvia,LVA,1962,1188070,993516,2181586
Latvia,LVA,1963,1221599,989320,2210919
Latvia,LVA,1964,1255757,984866,2240623
Latvia,LVA,1965,1287767,978152,2265919
Latvia,LVA,1966,1315521,967696,2283217
Latvia,LVA,1967,1343866,957354,2301220
Latvia,LVA,1968,1375002,948617,2323619
Latvia,LVA,1969,1404638,938535,2343173
Latvia,LVA,1970,1432319,926845,2359164
Latvia,LVA,1971,1459887,916502,2376389
Latvia,LVA,1972,1488241,907433,2395674
Latvia,LVA,1973,1517255,898564,2415819
Latvia,LVA,1974,1547223,889963,2437186
Latvia,LVA,1975,1575779,880351,2456130
Latvia,LVA,1976,1601843,869146,2470989
Latvia,LVA,1977,1627400,857673,2485073
Latvia,LVA,1978,1652200,845721,2497921
Latvia,LVA,1979,1671120,834833,2505953
Latvia,LVA,1980,1685226,826475,2511701
Latvia,LVA,1981,1699098,820323,2519421
Latvia,LVA,1982,1714098,816982,2531080
Latvia,LVA,1983,1731364,814647,2546011
Latvia,LVA,1984,1749443,812604,2562047
Latvia,LVA,1985,1768075,810798,2578873
Latvia,LVA,1986,1788258,811634,2599892
Latvia,LVA,1987,1810950,815633,2626583
Latvia,LVA,1988,1833841,819593,2653434
Latvia,LVA,1989,1845533,821422,2666955
Latvia,LVA,1990,1844232,818919,2663151
Latvia,LVA,1991,1834229,816352,2650581
Latvia,LVA,1992,1800024,814314,2614338
Latvia,LVA,1993,1763518,799772,2563290
Latvia,LVA,1994,1736816,783926,2520742
Latvia,LVA,1995,1708476,776580,2485056
Latvia,LVA,1996,1686883,770339,2457222
Latvia,LVA,1997,1668936,763915,2432851
Latvia,LVA,1998,1649682,760337,2410019
Latvia,LVA,1999,1630787,759695,2390482
Latvia,LVA,2000,1611520,756030,2367550
Latvia,LVA,2001,1588107,749063,2337170
Latvia,LVA,2002,1567452,742721,2310173
Latvia,LVA,2003,1551233,736722,2287955
Latvia,LVA,2004,1536660,726462,2263122
Latvia,LVA,2005,1522383,716416,2238799
Latvia,LVA,2006,1507751,710606,2218357
Latvia,LVA,2007,1494021,706304,2200325
Latvia,LVA,2008,1476965,700357,2177322
Latvia,LVA,2009,1452351,689318,2141669
Latvia,LVA,2010,1423002,674553,2097555
Latvia,LVA,2011,1397904,661805,2059709
Latvia,LVA,2012,1381242,653077,2034319
Latvia,LVA,2013,1367090,645557,2012647
Latvia,LVA,2014,1354815,638967,1993782
Latvia,LVA,2015,1344323,633204,1977527
Latvia,LVA,2016,1332897,626640,1959537
Latvia,LVA,2017,1322185,620063,1942248
Latvia,LVA,2018,1313215,613959,1927174
Latvia,LVA,2019,1305648,608174,1913822
Latvia,LVA,2020,1298292,602157,1900449
Latvia,LVA,2021,1289387,595103,1884490
Lebanon,LBN,1960,761366,1036726,1798092
Lebanon,LBN,1961,816173,1037122,1853295
Lebanon,LBN,1962,874759,1037200,1911959
Lebanon,LBN,1963,935975,1035536,1971511
Lebanon,LBN,1964,999119,1031321,2030440
Lebanon,LBN,1965,1063240,1024205,2087445
Lebanon,LBN,1966,1129983,1015663,2145646
Lebanon,LBN,1967,1198233,1004969,2203202
Lebanon,LBN,1968,1269168,993123,2262291
Lebanon,LBN,1969,1343077,980746,2323823
Lebanon,LBN,1970,1416570,965221,2381791
Lebanon,LBN,1971,1491169,950968,2442137
Lebanon,LBN,1972,1568233,937732,2505965
Lebanon,LBN,1973,1646549,923292,2569841
Lebanon,LBN,1974,1725590,907290,2632880
Lebanon,LBN,1975,1802770,888816,2691586
Lebanon,LBN,1976,2099767,970652,3070419
Lebanon,LBN,1977,2411999,1045618,3457617
Lebanon,LBN,1978,2263369,920036,3183405
Lebanon,LBN,1979,2101254,800910,2902164
Lebanon,LBN,1980,2183419,780283,2963702
Lebanon,LBN,1981,2267359,759863,3027222
Lebanon,LBN,1982,2336033,734100,3070133
Lebanon,LBN,1983,2399839,707151,3106990
Lebanon,LBN,1984,2478743,684815,3163558
Lebanon,LBN,1985,2562749,664001,3226750
Lebanon,LBN,1986,2661426,646584,3308010
Lebanon,LBN,1987,2761728,629142,3390870
Lebanon,LBN,1988,2848690,608458,3457148
Lebanon,LBN,1989,2917811,607691,3525502
Lebanon,LBN,1990,2987083,606617,3593700
Lebanon,LBN,1991,3060696,606038,3666734
Lebanon,LBN,1992,3139325,606082,3745407
Lebanon,LBN,1993,3213784,605012,3818796
Lebanon,LBN,1994,3285132,603012,3888144
Lebanon,LBN,1995,3358567,601073,3959640
Lebanon,LBN,1996,3434835,599408,4034243
Lebanon,LBN,1997,3510272,597279,4107551
Lebanon,LBN,1998,3584143,594641,4178784
Lebanon,LBN,1999,3650130,599890,4250020
Lebanon,LBN,2000,3715752,604890,4320642
Lebanon,LBN,2001,3779891,609309,4389200
Lebanon,LBN,2002,3834805,611861,4446666
Lebanon,LBN,2003,3890622,614185,4504807
Lebanon,LBN,2004,3956925,617872,4574797
Lebanon,LBN,2005,4022130,620914,4643044
Lebanon,LBN,2006,4095048,624816,4719864
Lebanon,LBN,2007,4179597,630011,4809608
Lebanon,LBN,2008,4254276,633337,4887613
Lebanon,LBN,2009,4316746,634389,4951135
Lebanon,LBN,2010,4363032,632768,4995800
Lebanon,LBN,2011,4413617,631439,5045056
Lebanon,LBN,2012,4538087,640250,5178337
Lebanon,LBN,2013,4985463,693388,5678851
Lebanon,LBN,2014,5518096,756246,6274342
Lebanon,LBN,2015,5637850,761090,6398940
Lebanon,LBN,2016,5524233,734386,6258619
Lebanon,LBN,2017,5402350,706902,6109252
Lebanon,LBN,2018,5272027,678812,5950839
Lebanon,LBN,2019,5131905,650002,5781907
Lebanon,LBN,2020,5035754,627169,5662923
Lebanon,LBN,2021,4982643,609988,5592631
Lesotho,LSO,1960,25913,711925,737838
Lesotho,LSO,1961,30131,730764,760895
Lesotho,LSO,1962,35028,749653,784681
Lesotho,LSO,1963,40692,768446,809138
Lesotho,LSO,1964,47225,786990,834215
Lesotho,LSO,1965,54762,805458,860220
Lesotho,LSO,1966,62726,825115,887841
Lesotho,LSO,1967,68230,850693,918923
Lesotho,LSO,1968,74352,878640,952992
Lesotho,LSO,1969,80969,906940,987909
Lesotho,LSO,1970,88101,935380,1023481
Lesotho,LSO,1971,95802,964077,1059879
Lesotho,LSO,1972,103953,993289,1097242
Lesotho,LSO,1973,112484,1023147,1135631
Lesotho,LSO,1974,121709,1053660,1175369
Lesotho,LSO,1975,131615,1084565,1216180
Lesotho,LSO,1976,140889,1115589,1256478
Lesotho,LSO,1977,145909,1148526,1294435
Lesotho,LSO,1978,150840,1180373,1331213
Lesotho,LSO,1979,155920,1212997,1368917
Lesotho,LSO,1980,161178,1246494,1407672
Lesotho,LSO,1981,166607,1280894,1447501
Lesotho,LSO,1982,172208,1316191,1488399
Lesotho,LSO,1983,177977,1352354,1530331
Lesotho,LSO,1984,183931,1389336,1573267
Lesotho,LSO,1985,189994,1426703,1616697
Lesotho,LSO,1986,197598,1462195,1659793
Lesotho,LSO,1987,210566,1488373,1698939
Lesotho,LSO,1988,223669,1510064,1733733
Lesotho,LSO,1989,237232,1529859,1767091
Lesotho,LSO,1990,251266,1547731,1798997
Lesotho,LSO,1991,265773,1563736,1829509
Lesotho,LSO,1992,280746,1577761,1858507
Lesotho,LSO,1993,296077,1589401,1885478
Lesotho,LSO,1994,311798,1598844,1910642
Lesotho,LSO,1995,327923,1606156,1934079
Lesotho,LSO,1996,343530,1611568,1955098
Lesotho,LSO,1997,356031,1616548,1972579
Lesotho,LSO,1998,368098,1617541,1985639
Lesotho,LSO,1999,379664,1614579,1994243
Lesotho,LSO,2000,390692,1607938,1998630
Lesotho,LSO,2001,401234,1598239,1999473
Lesotho,LSO,2002,411432,1586102,1997534
Lesotho,LSO,2003,421267,1571763,1993030
Lesotho,LSO,2004,430610,1554774,1985384
Lesotho,LSO,2005,439957,1537467,1977424
Lesotho,LSO,2006,451101,1525679,1976780
Lesotho,LSO,2007,462227,1521238,1983465
Lesotho,LSO,2008,474734,1520280,1995014
Lesotho,LSO,2009,488087,1521082,2009169
Lesotho,LSO,2010,501601,1521146,2022747
Lesotho,LSO,2011,515736,1521941,2037677
Lesotho,LSO,2012,528145,1526573,2054718
Lesotho,LSO,2013,541319,1532620,2073939
Lesotho,LSO,2014,555281,1539961,2095242
Lesotho,LSO,2015,570052,1548469,2118521
Lesotho,LSO,2016,585642,1558230,2143872
Lesotho,LSO,2017,601912,1568705,2170617
Lesotho,LSO,2018,618808,1579209,2198017
Lesotho,LSO,2019,636217,1589485,2225702
Lesotho,LSO,2020,654320,1599780,2254100
Lesotho,LSO,2021,672573,1608881,2281454
Liberia,LBR,1960,211851,925175,1137026
Liberia,LBR,1961,224741,940264,1165005
Liberia,LBR,1962,238447,955638,1194085
Liberia,LBR,1963,252962,971207,1224169
Liberia,LBR,1964,268336,986861,1255197
Liberia,LBR,1965,284600,1002715,1287315
Liberia,LBR,1966,301771,1018544,1320315
Liberia,LBR,1967,319910,1034377,1354287
Liberia,LBR,1968,339124,1050329,1389453
Liberia,LBR,1969,359421,1066458,1425879
Liberia,LBR,1970,380892,1082671,1463563
Liberia,LBR,1971,403345,1098313,1501658
Liberia,LBR,1972,427056,1113939,1540995
Liberia,LBR,1973,452351,1130346,1582697
Liberia,LBR,1974,479266,1147017,1626283
Liberia,LBR,1975,507875,1163757,1671632
Liberia,LBR,1976,538074,1180408,1718482
Liberia,LBR,1977,570245,1197847,1768092
Liberia,LBR,1978,604690,1216171,1820861
Liberia,LBR,1979,641087,1234479,1875566
Liberia,LBR,1980,679486,1252683,1932169
Liberia,LBR,1981,719532,1270158,1989690
Liberia,LBR,1982,761155,1286447,2047602
Liberia,LBR,1983,805569,1303582,2109151
Liberia,LBR,1984,866068,1308126,2174194
Liberia,LBR,1985,949038,1290686,2239724
Liberia,LBR,1986,1036622,1269238,2305860
Liberia,LBR,1987,1128503,1243946,2372449
Liberia,LBR,1988,1224577,1215062,2439639
Liberia,LBR,1989,1324364,1183236,2507600
Liberia,LBR,1990,1224677,985054,2209731
Liberia,LBR,1991,1124757,814479,1939236
Liberia,LBR,1992,1129334,923292,2052626
Liberia,LBR,1993,1109233,1023538,2132771
Liberia,LBR,1994,1040943,1084255,2125198
Liberia,LBR,1995,984657,1157765,2142422
Liberia,LBR,1996,946912,1257054,2203966
Liberia,LBR,1997,1032064,1351236,2383300
Liberia,LBR,1998,1151916,1487308,2639224
Liberia,LBR,1999,1227152,1562591,2789743
Liberia,LBR,2000,1283482,1611742,2895224
Liberia,LBR,2001,1331992,1649656,2981648
Liberia,LBR,2002,1377790,1682809,3060599
Liberia,LBR,2003,1399465,1685708,3085173
Liberia,LBR,2004,1427146,1695301,3122447
Liberia,LBR,2005,1504172,1762146,3266318
Liberia,LBR,2006,1603166,1852231,3455397
Liberia,LBR,2007,1698015,1934725,3632740
Liberia,LBR,2008,1781757,2002130,3783887
Liberia,LBR,2009,1852759,2052307,3905066
Liberia,LBR,2010,1922062,2097894,4019956
Liberia,LBR,2011,2015022,2166128,4181150
Liberia,LBR,2012,2104489,2227251,4331740
Liberia,LBR,2013,2168719,2258594,4427313
Liberia,LBR,2014,2232447,2286951,4519398
Liberia,LBR,2015,2297862,2314467,4612329
Liberia,LBR,2016,2365002,2341095,4706097
Liberia,LBR,2017,2431748,2364883,4796631
Liberia,LBR,2018,2500972,2388419,4889391
Liberia,LBR,2019,2573157,2412132,4985289
Liberia,LBR,2020,2650072,2437512,5087584
Liberia,LBR,2021,2730335,2463081,5193416
Libya,LBY,1960,389895,1037091,1426986
Libya,LBY,1961,416966,1061794,1478760
Libya,LBY,1962,446562,1088595,1535157
Libya,LBY,1963,478396,1116362,1594758
Libya,LBY,1964,510896,1141206,1652102
Libya,LBY,1965,572346,1127726,1700072
Libya,LBY,1966,638483,1101348,1739831
Libya,LBY,1967,708568,1070010,1778578
Libya,LBY,1968,783613,1035780,1819393
Libya,LBY,1969,863456,999367,1862823
Libya,LBY,1970,948307,960870,1909177
Libya,LBY,1971,1037753,920567,1958320
Libya,LBY,1972,1133043,879753,2012796
Libya,LBY,1973,1240716,843540,2084256
Libya,LBY,1974,1334627,844819,2179446
Libya,LBY,1975,1438932,852909,2291841
Libya,LBY,1976,1552289,861471,2413760
Libya,LBY,1977,1672559,869246,2541805
Libya,LBY,1978,1800090,876027,2676117
Libya,LBY,1979,1935109,881808,2816917
Libya,LBY,1980,2076689,886031,2962720
Libya,LBY,1981,2223566,888449,3112015
Libya,LBY,1982,2376371,889086,3265457
Libya,LBY,1983,2535341,888251,3423592
Libya,LBY,1984,2684104,880443,3564547
Libya,LBY,1985,2779814,904499,3684313
Libya,LBY,1986,2869273,930837,3800110
Libya,LBY,1987,2955861,956078,3911939
Libya,LBY,1988,3040866,980699,4021565
Libya,LBY,1989,3125161,1004881,4130042
Libya,LBY,1990,3208371,1028612,4236983
Libya,LBY,1991,3290215,1051756,4341971
Libya,LBY,1992,3370596,1074224,4444820
Libya,LBY,1993,3448996,1095974,4544970
Libya,LBY,1994,3524600,1116696,4641296
Libya,LBY,1995,3596844,1136219,4733063
Libya,LBY,1996,3665564,1154502,4820066
Libya,LBY,1997,3731372,1170974,4902346
Libya,LBY,1998,3795144,1185818,4980962
Libya,LBY,1999,3858443,1199555,5057998
Libya,LBY,2000,3937589,1217201,5154790
Libya,LBY,2001,4036181,1239735,5275916
Libya,LBY,2002,4142047,1263279,5405326
Libya,LBY,2003,4254975,1287666,5542641
Libya,LBY,2004,4374817,1312746,5687563
Libya,LBY,2005,4499920,1338066,5837986
Libya,LBY,2006,4614607,1358762,5973369
Libya,LBY,2007,4721471,1375706,6097177
Libya,LBY,2008,4835208,1393162,6228370
Libya,LBY,2009,4950582,1409609,6360191
Libya,LBY,2010,5067126,1424862,6491988
Libya,LBY,2011,4843884,1344248,6188132
Libya,LBY,2012,4608552,1261318,5869870
Libya,LBY,2013,4713721,1271500,5985221
Libya,LBY,2014,4817782,1279982,6097764
Libya,LBY,2015,4908585,1283650,6192235
Libya,LBY,2016,4996859,1285337,6282196
Libya,LBY,2017,5090937,1287324,6378261
Libya,LBY,2018,5188842,1288951,6477793
Libya,LBY,2019,5281087,1288001,6569088
Libya,LBY,2020,5369132,1284810,6653942
Libya,LBY,2021,5455170,1280107,6735277
Liechtenstein,LIE,1960,3366,13106,16472
Liechtenstein,LIE,1961,3420,13414,16834
Liechtenstein,LIE,1962,3462,13759,17221
Liechtenstein,LIE,1963,3506,14119,17625
Liechtenstein,LIE,1964,3554,14504,18058
Liechtenstein,LIE,1965,3602,14898,18500
Liechtenstein,LIE,1966,3652,15305,18957
Liechtenstein,LIE,1967,3710,15757,19467
Liechtenstein,LIE,1968,3773,16238,20011
Liechtenstein,LIE,1969,3835,16723,20558
Liechtenstein,LIE,1970,3892,17197,21089
Liechtenstein,LIE,1971,3951,17566,21517
Liechtenstein,LIE,1972,4015,17858,21873
Liechtenstein,LIE,1973,4082,18169,22251
Liechtenstein,LIE,1974,4150,18488,22638
Liechtenstein,LIE,1975,4220,18810,23030
Liechtenstein,LIE,1976,4288,19128,23416
Liechtenstein,LIE,1977,4357,19446,23803
Liechtenstein,LIE,1978,4428,19777,24205
Liechtenstein,LIE,1979,4501,20115,24616
Liechtenstein,LIE,1980,4569,20434,25003
Liechtenstein,LIE,1981,4610,20736,25346
Liechtenstein,LIE,1982,4635,21054,25689
Liechtenstein,LIE,1983,4664,21391,26055
Liechtenstein,LIE,1984,4692,21728,26420
Liechtenstein,LIE,1985,4719,22066,26785
Liechtenstein,LIE,1986,4747,22412,27159
Liechtenstein,LIE,1987,4776,22766,27542
Liechtenstein,LIE,1988,4807,23137,27944
Liechtenstein,LIE,1989,4839,23518,28357
Liechtenstein,LIE,1990,4869,23896,28765
Liechtenstein,LIE,1991,4906,24262,29168
Liechtenstein,LIE,1992,4951,24630,29581
Liechtenstein,LIE,1993,4997,25015,30012
Liechtenstein,LIE,1994,5044,25403,30447
Liechtenstein,LIE,1995,5091,25799,30890
Liechtenstein,LIE,1996,5105,26232,31337
Liechtenstein,LIE,1997,5081,26689,31770
Liechtenstein,LIE,1998,5054,27136,32190
Liechtenstein,LIE,1999,5027,27588,32615
Liechtenstein,LIE,2000,4997,28029,33026
Liechtenstein,LIE,2001,4994,28382,33376
Liechtenstein,LIE,2002,5022,28671,33693
Liechtenstein,LIE,2003,5049,28951,34000
Liechtenstein,LIE,2004,5075,29225,34300
Liechtenstein,LIE,2005,5100,29503,34603
Liechtenstein,LIE,2006,5123,29766,34889
Liechtenstein,LIE,2007,5142,30008,35150
Liechtenstein,LIE,2008,5159,30242,35401
Liechtenstein,LIE,2009,5180,30495,35675
Liechtenstein,LIE,2010,5196,30730,35926
Liechtenstein,LIE,2011,5215,30974,36189
Liechtenstein,LIE,2012,5245,31260,36505
Liechtenstein,LIE,2013,5276,31530,36806
Liechtenstein,LIE,2014,5310,31786,37096
Liechtenstein,LIE,2015,5343,32012,37355
Liechtenstein,LIE,2016,5379,32230,37609
Liechtenstein,LIE,2017,5424,32465,37889
Liechtenstein,LIE,2018,5474,32707,38181
Liechtenstein,LIE,2019,5530,32952,38482
Liechtenstein,LIE,2020,5587,33169,38756
Liechtenstein,LIE,2021,5649,33390,39039
Lithuania,LTU,1960,1096416,1682134,2778550
Lithuania,LTU,1961,1141928,1681622,2823550
Lithuania,LTU,1962,1186429,1676921,2863350
Lithuania,LTU,1963,1230140,1668810,2898950
Lithuania,LTU,1964,1275080,1660120,2935200
Lithuania,LTU,1965,1320810,1650640,2971450
Lithuania,LTU,1966,1367610,1640440,3008050
Lithuania,LTU,1967,1415159,1629241,3044400
Lithuania,LTU,1968,1462669,1616181,3078850
Lithuania,LTU,1969,1507983,1599338,3107321
Lithuania,LTU,1970,1555873,1583816,3139689
Lithuania,LTU,1971,1612378,1566663,3179041
Lithuania,LTU,1972,1670055,1543567,3213622
Lithuania,LTU,1973,1726365,1518073,3244438
Lithuania,LTU,1974,1782668,1491226,3273894
Lithuania,LTU,1975,1838525,1463127,3301652
Lithuania,LTU,1976,1894509,1434155,3328664
Lithuania,LTU,1977,1950350,1404686,3355036
Lithuania,LTU,1978,2005471,1374043,3379514
Lithuania,LTU,1979,2050971,1346871,3397842
Lithuania,LTU,1980,2087446,1325756,3413202
Lithuania,LTU,1981,2126573,1306374,3432947
Lithuania,LTU,1982,2168688,1288491,3457179
Lithuania,LTU,1983,2213306,1271886,3485192
Lithuania,LTU,1984,2258826,1255379,3514205
Lithuania,LTU,1985,2305300,1239243,3544543
Lithuania,LTU,1986,2354675,1224239,3578914
Lithuania,LTU,1987,2406331,1210036,3616367
Lithuania,LTU,1988,2459117,1195932,3655049
Lithuania,LTU,1989,2492104,1192151,3684255
Lithuania,LTU,1990,2499110,1198728,3697838
Lithuania,LTU,1991,2501142,1202992,3704134
Lithuania,LTU,1992,2496245,1203869,3700114
Lithuania,LTU,1993,2482228,1200385,3682613
Lithuania,LTU,1994,2462904,1194240,3657144
Lithuania,LTU,1995,2441841,1187261,3629102
Lithuania,LTU,1996,2421184,1180429,3601613
Lithuania,LTU,1997,2401277,1173860,3575137
Lithuania,LTU,1998,2381814,1167517,3549331
Lithuania,LTU,1999,2362861,1161377,3524238
Lithuania,LTU,2000,2344199,1155337,3499536
Lithuania,LTU,2001,2322637,1148181,3470818
Lithuania,LTU,2002,2300933,1142134,3443067
Lithuania,LTU,2003,2279211,1136002,3415213
Lithuania,LTU,2004,2250685,1126390,3377075
Lithuania,LTU,2005,2213967,1108561,3322528
Lithuania,LTU,2006,2181225,1088684,3269909
Lithuania,LTU,2007,2157761,1073533,3231294
Lithuania,LTU,2008,2137953,1060278,3198231
Lithuania,LTU,2009,2114156,1048760,3162916
Lithuania,LTU,2010,2067653,1029629,3097282
Lithuania,LTU,2011,2020994,1007121,3028115
Lithuania,LTU,2012,1997745,990028,2987773
Lithuania,LTU,2013,1981238,976451,2957689
Lithuania,LTU,2014,1967853,964514,2932367
Lithuania,LTU,2015,1952971,951939,2904910
Lithuania,LTU,2016,1932212,936019,2868231
Lithuania,LTU,2017,1909625,918778,2828403
Lithuania,LTU,2018,1896056,905487,2801543
Lithuania,LTU,2019,1895962,898175,2794137
Lithuania,LTU,2020,1901807,893078,2794885
Lithuania,LTU,2021,1911545,889294,2800839
Low-income countries,,1960,19193989,123204830,142398819
Low-income countries,,1961,20159011,125573340,145732351
Low-income countries,,1962,21179469,128019144,149198613
Low-income countries,,1963,22275349,130523960,152799309
Low-income countries,,1964,23455355,133123830,156579185
Low-income countries,,1965,24710016,135819120,160529136
Low-income countries,,1966,26043962,138554290,164598252
Low-income countries,,1967,27478568,141392180,168870748
Low-income countries,,1968,29109096,144243550,173352646
Low-income countries,,1969,30914025,147022830,177936855
Low-income countries,,1970,32753919,149881700,182635619
Low-income countries,,1971,34302074,153125250,187427324
Low-income countries,,1972,35917168,156313490,192230658
Low-income countries,,1973,37575282,159599940,197175222
Low-income countries,,1974,39237361,163130600,202367961
Low-income countries,,1975,40951901,166745820,207697721
Low-income countries,,1976,42628573,170509580,213138153
Low-income countries,,1977,44352694,174203220,218555914
Low-income countries,,1978,46225016,178244110,224469126
Low-income countries,,1979,48199619,182469940,230669559
Low-income countries,,1980,50071035,185719700,235790735
Low-income countries,,1981,51834895,188543740,240378635
Low-income countries,,1982,53798032,192271840,246069872
Low-income countries,,1983,56051580,196518740,252570320
Low-income countries,,1984,58536847,200801620,259338467
Low-income countries,,1985,61209328,205077800,266287128
Low-income countries,,1986,63944023,209276800,273220823
Low-income countries,,1987,66765090,213620460,280385550
Low-income countries,,1988,69646187,217973940,287620127
Low-income countries,,1989,72610853,222587870,295198723
Low-income countries,,1990,75571710,227228480,302800190
Low-income countries,,1991,78431701,232168020,310599721
Low-income countries,,1992,81710401,238193700,319904101
Low-income countries,,1993,85304736,244685760,329990496
Low-income countries,,1994,88846539,250737760,339584299
Low-income countries,,1995,92351122,256982370,349333492
Low-income countries,,1996,95688939,263927310,359616249
Low-income countries,,1997,99137011,270594500,369731511
Low-income countries,,1998,102698658,277124600,379823258
Low-income countries,,1999,106425105,283951000,390376105
Low-income countries,,2000,110204801,290616770,400821571
Low-income countries,,2001,114205930,297356030,411561960
Low-income countries,,2002,118653082,305204900,423857982
Low-income countries,,2003,123289408,313533660,436823068
Low-income countries,,2004,127977256,321526200,449503456
Low-income countries,,2005,132975732,329615870,462591602
Low-income countries,,2006,138434334,338180900,476615234
Low-income countries,,2007,143828135,347131780,490959915
Low-income countries,,2008,149837719,355435800,505273519
Low-income countries,,2009,155951332,363997220,519948552
Low-income countries,,2010,162363734,372596400,534960134
Low-income countries,,2011,168676091,381623780,550299871
Low-income countries,,2012,174842240,390693730,565535970
Low-income countries,,2013,180779519,399346660,580126179
Low-income countries,,2014,186912006,407861440,594773446
Low-income countries,,2015,193929402,416117860,610047262
Low-income countries,,2016,201638507,424743740,626382247
Low-income countries,,2017,209853209,433632480,643485689
Low-income countries,,2018,218517548,442739040,661256588
Low-income countries,,2019,227761784,452251680,680013464
Low-income countries,,2020,237349346,461837200,699186546
Low-income countries,,2021,247129654,471125400,718255054
Lower-middle-income countries,,1960,195241647,794359800,989601447
Lower-middle-income countries,,1961,202434480,811261400,1013695880
Lower-middle-income countries,,1962,210187532,828205900,1038393432
Lower-middle-income countries,,1963,218253680,845558300,1063811980
Lower-middle-income countries,,1964,226618795,863232450,1089851245
Lower-middle-income countries,,1965,235198990,880661400,1115860390
Lower-middle-income countries,,1966,243916229,897978800,1141895029
Lower-middle-income countries,,1967,252948085,915714000,1168662085
Lower-middle-income countries,,1968,262394631,933929660,1196324291
Lower-middle-income countries,,1969,272205267,952585860,1224791127
Lower-middle-income countries,,1970,282313353,971324200,1253637553
Lower-middle-income countries,,1971,293005084,989261900,1282266984
Lower-middle-income countries,,1972,304947699,1006907300,1311854999
Lower-middle-income countries,,1973,317528767,1025631170,1343159937
Lower-middle-income countries,,1974,330676398,1044533760,1375210158
Lower-middle-income countries,,1975,342646377,1065282800,1407929177
Lower-middle-income countries,,1976,357130108,1084423300,1441553408
Lower-middle-income countries,,1977,372090881,1104090100,1476180981
Lower-middle-income countries,,1978,387250453,1124018400,1511268853
Lower-middle-income countries,,1979,402915502,1144617600,1547533102
Lower-middle-income countries,,1980,419925399,1166372600,1586297999
Lower-middle-income countries,,1981,438025211,1189268100,1627293311
Lower-middle-income countries,,1982,455340776,1213385200,1668725976
Lower-middle-income countries,,1983,472958386,1237082000,1710040386
Lower-middle-income countries,,1984,491235116,1260629200,1751864316
Lower-middle-income countries,,1985,510179494,1284281500,1794460994
Lower-middle-income countries,,1986,529771715,1307948700,1837720415
Lower-middle-income countries,,1987,549740690,1331541900,1881282590
Lower-middle-income countries,,1988,570128177,1355032300,1925160477
Lower-middle-income countries,,1989,590893873,1378555500,1969449373
Lower-middle-income countries,,1990,613720583,1402861200,2016581783
Lower-middle-income countries,,1991,634816411,1427035500,2061851911
Lower-middle-income countries,,1992,655578687,1450331500,2105910187
Lower-middle-income countries,,1993,676104374,1473211400,2149315774
Lower-middle-income countries,,1994,696913130,1496019800,2192932930
Lower-middle-income countries,,1995,718189795,1518754800,2236944595
Lower-middle-income countries,,1996,739872163,1540944000,2280816163
Lower-middle-income countries,,1997,762069549,1562949200,2325018749
Lower-middle-income countries,,1998,784737286,1584891900,2369629186
Lower-middle-income countries,,1999,807654212,1606557700,2414211912
Lower-middle-income countries,,2000,831329755,1628220000,2459549755
Lower-middle-income countries,,2001,855629549,1649805400,2505434949
Lower-middle-income countries,,2002,880827966,1669414900,2550242866
Lower-middle-income countries,,2003,906393615,1688130800,2594524415
Lower-middle-income countries,,2004,932764512,1706533000,2639297512
Lower-middle-income countries,,2005,959518064,1724092400,2683610464
Lower-middle-income countries,,2006,986522345,1740741000,2727263345
Lower-middle-income countries,,2007,1014041518,1756925200,2770966718
Lower-middle-income countries,,2008,1042088543,1772578700,2814667243
Lower-middle-income countries,,2009,1070808942,1788011100,2858820042
Lower-middle-income countries,,2010,1100575524,1803931400,2904506924
Lower-middle-income countries,,2011,1130922560,1819885200,2950807760
Lower-middle-income countries,,2012,1161654015,1835048100,2996702115
Lower-middle-income countries,,2013,1193288207,1849650400,3042938607
Lower-middle-income countries,,2014,1225660705,1863434800,3089095505
Lower-middle-income countries,,2015,1258365298,1876371200,3134736498
Lower-middle-income countries,,2016,1291311833,1888909200,3180221033
Lower-middle-income countries,,2017,1324700256,1900875500,3225575756
Lower-middle-income countries,,2018,1358481166,1911733600,3270214766
Lower-middle-income countries,,2019,1392531817,1921371600,3313903417
Lower-middle-income countries,,2020,1426963556,1930154600,3357118156
Lower-middle-income countries,,2021,1461124304,1937063200,3398187504
Luxembourg,LUX,1960,218385,95585,313970
Luxembourg,LUX,1961,221560,95285,316845
Luxembourg,LUX,1962,225946,94804,320750
Luxembourg,LUX,1963,229959,94141,324100
Luxembourg,LUX,1964,234207,93543,327750
Luxembourg,LUX,1965,238541,92959,331500
Luxembourg,LUX,1966,241914,91981,333895
Luxembourg,LUX,1967,244349,90646,334995
Luxembourg,LUX,1968,246598,89252,335850
Luxembourg,LUX,1969,249419,88081,337500
Luxembourg,LUX,1970,252255,86916,339171
Luxembourg,LUX,1971,256528,85893,342421
Luxembourg,LUX,1972,261780,84820,346600
Luxembourg,LUX,1973,266787,83663,350450
Luxembourg,LUX,1974,272384,82666,355050
Luxembourg,LUX,1975,277458,81492,358950
Luxembourg,LUX,1976,280890,79841,360731
Luxembourg,LUX,1977,283399,77959,361358
Luxembourg,LUX,1978,285895,76112,362007
Luxembourg,LUX,1979,288518,74338,362856
Luxembourg,LUX,1980,291473,72677,364150
Luxembourg,LUX,1981,293802,71423,365225
Luxembourg,LUX,1982,294251,71274,365525
Luxembourg,LUX,1983,294534,71088,365622
Luxembourg,LUX,1984,295042,70956,365998
Luxembourg,LUX,1985,295818,70888,366706
Luxembourg,LUX,1986,297355,71000,368355
Luxembourg,LUX,1987,299492,71258,370750
Luxembourg,LUX,1988,301882,71568,373450
Luxembourg,LUX,1989,305040,72060,377100
Luxembourg,LUX,1990,309096,72754,381850
Luxembourg,LUX,1991,313973,73027,387000
Luxembourg,LUX,1992,319732,72443,392175
Luxembourg,LUX,1993,325361,72114,397475
Luxembourg,LUX,1994,332341,70584,402925
Luxembourg,LUX,1995,338722,69903,408625
Luxembourg,LUX,1996,343082,71143,414225
Luxembourg,LUX,1997,347217,72233,419450
Luxembourg,LUX,1998,352047,72653,424700
Luxembourg,LUX,1999,359223,71252,430475
Luxembourg,LUX,2000,367434,68866,436300
Luxembourg,LUX,2001,374603,66922,441525
Luxembourg,LUX,2002,380583,65592,446175
Luxembourg,LUX,2003,387241,64389,451630
Luxembourg,LUX,2004,394773,63322,458095
Luxembourg,LUX,2005,402818,62340,465158
Luxembourg,LUX,2006,411237,61400,472637
Luxembourg,LUX,2007,419557,60436,479993
Luxembourg,LUX,2008,429035,59615,488650
Luxembourg,LUX,2009,438935,58848,497783
Luxembourg,LUX,2010,448892,58061,506953
Luxembourg,LUX,2011,460842,57505,518347
Luxembourg,LUX,2012,473864,57082,530946
Luxembourg,LUX,2013,486709,56651,543360
Luxembourg,LUX,2014,500042,56277,556319
Luxembourg,LUX,2015,513663,55941,569604
Luxembourg,LUX,2016,526490,55524,582014
Luxembourg,LUX,2017,541038,55298,596336
Luxembourg,LUX,2018,553119,54831,607950
Luxembourg,LUX,2019,565584,54417,620001
Luxembourg,LUX,2020,576537,53882,630419
Luxembourg,LUX,2021,586759,53305,640064
Macao,MAC,1960,168675,8339,177014
Macao,MAC,1961,170324,8348,178672
Macao,MAC,1962,177771,8268,186039
Macao,MAC,1963,185434,8184,193618
Macao,MAC,1964,193285,8095,201380
Macao,MAC,1965,201277,8001,209278
Macao,MAC,1966,209336,7896,217232
Macao,MAC,1967,217370,7781,225151
Macao,MAC,1968,225277,7652,232929
Macao,MAC,1969,232908,7508,240416
Macao,MAC,1970,239945,7339,247284
Macao,MAC,1971,242857,6975,249832
Macao,MAC,1972,242196,6473,248669
Macao,MAC,1973,241823,6015,247838
Macao,MAC,1974,241687,5593,247280
Macao,MAC,1975,241711,5208,246919
Macao,MAC,1976,241814,4847,246661
Macao,MAC,1977,241893,4512,246405
Macao,MAC,1978,241850,4198,246048
Macao,MAC,1979,241700,3905,245605
Macao,MAC,1980,241699,3633,245332
Macao,MAC,1981,245350,3345,248695
Macao,MAC,1982,253840,2852,256692
Macao,MAC,1983,263814,2439,266253
Macao,MAC,1984,274500,2091,276591
Macao,MAC,1985,285908,1792,287700
Macao,MAC,1986,297952,1539,299491
Macao,MAC,1987,310486,1322,311808
Macao,MAC,1988,323346,1132,324478
Macao,MAC,1989,336364,972,337336
Macao,MAC,1990,349397,830,350227
Macao,MAC,1991,361683,707,362390
Macao,MAC,1992,371770,600,372370
Macao,MAC,1993,380206,506,380712
Macao,MAC,1994,388355,424,388779
Macao,MAC,1995,396284,357,396641
Macao,MAC,1996,404216,81,404297
Macao,MAC,1997,411700,0,411700
Macao,MAC,1998,418776,0,418776
Macao,MAC,1999,425518,0,425518
Macao,MAC,2000,431896,0,431896
Macao,MAC,2001,439122,0,439122
Macao,MAC,2002,449665,0,449665
Macao,MAC,2003,462533,0,462533
Macao,MAC,2004,475529,0,475529
Macao,MAC,2005,488619,0,488619
Macao,MAC,2006,501863,0,501863
Macao,MAC,2007,515330,0,515330
Macao,MAC,2008,529038,0,529038
Macao,MAC,2009,543021,0,543021
Macao,MAC,2010,557297,0,557297
Macao,MAC,2011,571003,0,571003
Macao,MAC,2012,582766,0,582766
Macao,MAC,2013,593374,0,593374
Macao,MAC,2014,604167,0,604167
Macao,MAC,2015,615239,0,615239
Macao,MAC,2016,626688,0,626688
Macao,MAC,2017,638609,0,638609
Macao,MAC,2018,650991,0,650991
Macao,MAC,2019,663653,0,663653
Macao,MAC,2020,676283,0,676283
Macao,MAC,2021,686607,0,686607
Madagascar,MDG,1960,539905,4533437,5073342
Madagascar,MDG,1961,571176,4635063,5206239
Madagascar,MDG,1962,604253,4738864,5343117
Madagascar,MDG,1963,639299,4844953,5484252
Madagascar,MDG,1964,676391,4953633,5630024
Madagascar,MDG,1965,715562,5064891,5780453
Madagascar,MDG,1966,756721,5179740,5936461
Madagascar,MDG,1967,797452,5302077,6099529
Madagascar,MDG,1968,840878,5429650,6270528
Madagascar,MDG,1969,886984,5563340,6450324
Madagascar,MDG,1970,936205,5703546,6639751
Madagascar,MDG,1971,993645,5846812,6840457
Madagascar,MDG,1972,1055125,5995965,7051090
Madagascar,MDG,1973,1120158,6148402,7268560
Madagascar,MDG,1974,1188895,6303040,7491935
Madagascar,MDG,1975,1261125,6459734,7720859
Madagascar,MDG,1976,1332893,6622304,7955197
Madagascar,MDG,1977,1408253,6786889,8195142
Madagascar,MDG,1978,1487459,6953460,8440919
Madagascar,MDG,1979,1570523,7121766,8692289
Madagascar,MDG,1980,1657558,7290604,8948162
Madagascar,MDG,1981,1748284,7459026,9207310
Madagascar,MDG,1982,1843149,7627841,9470990
Madagascar,MDG,1983,1942466,7797622,9740088
Madagascar,MDG,1984,2046469,7968548,10015017
Madagascar,MDG,1985,2155627,8142119,10297746
Madagascar,MDG,1986,2270371,8318057,10588428
Madagascar,MDG,1987,2391448,8499066,10890514
Madagascar,MDG,1988,2520071,8686718,11206789
Madagascar,MDG,1989,2655872,8880862,11536734
Madagascar,MDG,1990,2800292,9082470,11882762
Madagascar,MDG,1991,2953434,9291826,12245260
Madagascar,MDG,1992,3115567,9507775,12623342
Madagascar,MDG,1993,3287705,9732395,13020100
Madagascar,MDG,1994,3431048,10005073,13436121
Madagascar,MDG,1995,3577683,10291455,13869138
Madagascar,MDG,1996,3730842,10586612,14317454
Madagascar,MDG,1997,3889955,10888948,14778903
Madagascar,MDG,1998,4054613,11196321,15250934
Madagascar,MDG,1999,4224215,11506670,15730885
Madagascar,MDG,2000,4398058,11818373,16216431
Madagascar,MDG,2001,4576944,12132721,16709665
Madagascar,MDG,2002,4761337,12450597,17211934
Madagascar,MDG,2003,4951463,12772847,17724310
Madagascar,MDG,2004,5148726,13102048,18250774
Madagascar,MDG,2005,5414776,13377395,18792171
Madagascar,MDG,2006,5693825,13656474,19350299
Madagascar,MDG,2007,5986055,13938903,19924958
Madagascar,MDG,2008,6291521,14222078,20513599
Madagascar,MDG,2009,6609861,14507231,21117092
Madagascar,MDG,2010,6940464,14790589,21731053
Madagascar,MDG,2011,7281030,15067128,22348158
Madagascar,MDG,2012,7630993,15335247,22966240
Madagascar,MDG,2013,7991167,15596906,23588073
Madagascar,MDG,2014,8362745,15853231,24215976
Madagascar,MDG,2015,8745781,16105131,24850912
Madagascar,MDG,2016,9143976,16357965,25501941
Madagascar,MDG,2017,9557640,16611902,26169542
Madagascar,MDG,2018,9984497,16862044,26846541
Madagascar,MDG,2019,10424320,17108814,27533134
Madagascar,MDG,2020,10876290,17348888,28225178
Madagascar,MDG,2021,11336960,17578692,28915652
Malawi,MWI,1960,158965,3462116,3621081
Malawi,MWI,1961,166461,3541732,3708193
Malawi,MWI,1962,174381,3624774,3799155
Malawi,MWI,1963,182767,3710861,3893628
Malawi,MWI,1964,191537,3798824,3990361
Malawi,MWI,1965,200693,3888404,4089097
Malawi,MWI,1966,210293,3980471,4190764
Malawi,MWI,1967,225485,4070277,4295762
Malawi,MWI,1968,242409,4161021,4403430
Malawi,MWI,1969,260527,4252334,4512861
Malawi,MWI,1970,279960,4345181,4625141
Malawi,MWI,1971,300910,4441570,4742480
Malawi,MWI,1972,323636,4542342,4865978
Malawi,MWI,1973,348238,4648001,4996239
Malawi,MWI,1974,375002,4759197,5134199
Malawi,MWI,1975,404099,4876866,5280965
Malawi,MWI,1976,435874,5002352,5438226
Malawi,MWI,1977,471047,5140665,5611712
Malawi,MWI,1978,501649,5307161,5808810
Malawi,MWI,1979,533036,5496104,6029140
Malawi,MWI,1980,567197,5700172,6267369
Malawi,MWI,1981,603938,5915953,6519891
Malawi,MWI,1982,643224,6141123,6784347
Malawi,MWI,1983,684939,6373378,7058317
Malawi,MWI,1984,728836,6610166,7339002
Malawi,MWI,1985,774937,6850141,7625078
Malawi,MWI,1986,822621,7087198,7909819
Malawi,MWI,1987,882777,7413216,8295993
Malawi,MWI,1988,957248,7797533,8754781
Malawi,MWI,1989,1031533,8143362,9174895
Malawi,MWI,1990,1102785,8436880,9539665
Malawi,MWI,1991,1168484,8663100,9831584
Malawi,MWI,1992,1235902,8879518,10115420
Malawi,MWI,1993,1288103,8969130,10257233
Malawi,MWI,1994,1307711,8824088,10131799
Malawi,MWI,1995,1341263,8771553,10112816
Malawi,MWI,1996,1405222,8905306,10310528
Malawi,MWI,1997,1471985,9040693,10512678
Malawi,MWI,1998,1543756,9188700,10732456
Malawi,MWI,1999,1593638,9380318,10973956
Malawi,MWI,2000,1640613,9588774,11229387
Malawi,MWI,2001,1690096,9808722,11498818
Malawi,MWI,2002,1742456,10042042,11784498
Malawi,MWI,2003,1798085,10289880,12087965
Malawi,MWI,2004,1857233,10554109,12411342
Malawi,MWI,2005,1920235,10835413,12755648
Malawi,MWI,2006,1986636,11131671,13118307
Malawi,MWI,2007,2056034,11439429,13495463
Malawi,MWI,2008,2128693,11760730,13889423
Malawi,MWI,2009,2206182,12092750,14298932
Malawi,MWI,2010,2287832,12430590,14718422
Malawi,MWI,2011,2373696,12772398,15146094
Malawi,MWI,2012,2463707,13117544,15581251
Malawi,MWI,2013,2558516,13466259,16024775
Malawi,MWI,2014,2658225,13819741,16477966
Malawi,MWI,2015,2763250,14175692,16938942
Malawi,MWI,2016,2872972,14532652,17405624
Malawi,MWI,2017,2988658,14892509,17881167
Malawi,MWI,2018,3110968,15256915,18367883
Malawi,MWI,2019,3240276,15627061,18867337
Malawi,MWI,2020,3376840,16000221,19377061
Malawi,MWI,2021,3519490,16370252,19889742
Malaysia,MYS,1960,2083629,5750153,7833782
Malaysia,MYS,1961,2199658,5875147,8074805
Malaysia,MYS,1962,2322041,6002177,8324218
Malaysia,MYS,1963,2450091,6129259,8579350
Malaysia,MYS,1964,2582918,6253007,8835925
Malaysia,MYS,1965,2719396,6371620,9091016
Malaysia,MYS,1966,2858487,6481753,9340240
Malaysia,MYS,1967,2999576,6582510,9582086
Malaysia,MYS,1968,3144095,6677213,9821308
Malaysia,MYS,1969,3293089,6768595,10061684
Malaysia,MYS,1970,3447939,6858569,10306508
Malaysia,MYS,1971,3616467,6936090,10552557
Malaysia,MYS,1972,3791800,7009819,10801619
Malaysia,MYS,1973,3976364,7086300,11062664
Malaysia,MYS,1974,4170669,7164518,11335187
Malaysia,MYS,1975,4374389,7243558,11617947
Malaysia,MYS,1976,4587644,7322437,11910081
Malaysia,MYS,1977,4813156,7405768,12218924
Malaysia,MYS,1978,5051551,7492341,12543892
Malaysia,MYS,1979,5299097,7575914,12875011
Malaysia,MYS,1980,5556412,7659295,13215707
Malaysia,MYS,1981,5806596,7757998,13564594
Malaysia,MYS,1982,6065949,7855080,13921029
Malaysia,MYS,1983,6338170,7954692,14292862
Malaysia,MYS,1984,6626381,8060073,14686454
Malaysia,MYS,1985,6933576,8174559,15108135
Malaysia,MYS,1986,7261420,8297320,15558740
Malaysia,MYS,1987,7607707,8425396,16033103
Malaysia,MYS,1988,7970153,8554463,16524616
Malaysia,MYS,1989,8341912,8678231,17020143
Malaysia,MYS,1990,8722442,8794612,17517054
Malaysia,MYS,1991,9112513,8904951,18017464
Malaysia,MYS,1992,9599428,8927280,18526708
Malaysia,MYS,1993,10117305,8932772,19050077
Malaysia,MYS,1994,10656646,8932057,19588703
Malaysia,MYS,1995,11213830,8923058,20136888
Malaysia,MYS,1996,11786345,8902706,20689051
Malaysia,MYS,1997,12374884,8874294,21249178
Malaysia,MYS,1998,12976400,8834142,21810542
Malaysia,MYS,1999,13587168,8781487,22368655
Malaysia,MYS,2000,14220716,8724434,22945150
Malaysia,MYS,2001,14813423,8729094,23542517
Malaysia,MYS,2002,15416400,8726045,24142445
Malaysia,MYS,2003,16026190,8713221,24739411
Malaysia,MYS,2004,16642423,8690824,25333247
Malaysia,MYS,2005,17263520,8660016,25923536
Malaysia,MYS,2006,17889347,8620066,26509413
Malaysia,MYS,2007,18520504,8572100,27092604
Malaysia,MYS,2008,19150609,8513687,27664296
Malaysia,MYS,2009,19773206,8443998,28217204
Malaysia,MYS,2010,20364317,8353414,28717731
Malaysia,MYS,2011,20898466,8285667,29184133
Malaysia,MYS,2012,21436918,8223294,29660212
Malaysia,MYS,2013,21977315,8157492,30134807
Malaysia,MYS,2014,22519314,8087145,30606459
Malaysia,MYS,2015,23057113,8011720,31068833
Malaysia,MYS,2016,23594371,7932047,31526418
Malaysia,MYS,2017,24124786,7851020,31975806
Malaysia,MYS,2018,24635110,7764161,32399271
Malaysia,MYS,2019,25130176,7673844,32804020
Malaysia,MYS,2020,25617115,7582878,33199993
Malaysia,MYS,2021,26085557,7488317,33573874
Maldives,MDV,1960,10240,81410,91650
Maldives,MDV,1961,10551,83401,93952
Maldives,MDV,1962,10874,85458,96332
Maldives,MDV,1963,11206,87569,98775
Maldives,MDV,1964,11546,89695,101241
Maldives,MDV,1965,11981,92585,104566
Maldives,MDV,1966,12386,96327,108713
Maldives,MDV,1967,12758,99789,112547
Maldives,MDV,1968,13364,102685,116049
Maldives,MDV,1969,13987,105582,119569
Maldives,MDV,1970,14657,108586,123243
Maldives,MDV,1971,16318,110748,127066
Maldives,MDV,1972,18153,112837,130990
Maldives,MDV,1973,20155,114785,134940
Maldives,MDV,1974,22349,116595,138944
Maldives,MDV,1975,24767,118359,143126
Maldives,MDV,1976,27423,120045,147468
Maldives,MDV,1977,30295,121497,151792
Maldives,MDV,1978,32731,123294,156025
Maldives,MDV,1979,34642,125684,160326
Maldives,MDV,1980,36687,128200,164887
Maldives,MDV,1981,38861,130802,169663
Maldives,MDV,1982,41142,133381,174523
Maldives,MDV,1983,43502,135837,179339
Maldives,MDV,1984,46012,138376,184388
Maldives,MDV,1985,48531,141852,190383
Maldives,MDV,1986,50430,146795,197225
Maldives,MDV,1987,52388,151868,204256
Maldives,MDV,1988,54325,156835,211160
Maldives,MDV,1989,56241,161696,217937
Maldives,MDV,1990,58129,166828,224957
Maldives,MDV,1991,59839,172311,232150
Maldives,MDV,1992,61489,177647,239136
Maldives,MDV,1993,63057,182788,245845
Maldives,MDV,1994,64528,187673,252201
Maldives,MDV,1995,66199,192009,258208
Maldives,MDV,1996,68620,195221,263841
Maldives,MDV,1997,70970,198070,269040
Maldives,MDV,1998,73254,200542,273796
Maldives,MDV,1999,75463,202648,278111
Maldives,MDV,2000,78271,204236,282507
Maldives,MDV,2001,82919,204405,287324
Maldives,MDV,2002,87808,204476,292284
Maldives,MDV,2003,92889,204337,297226
Maldives,MDV,2004,98164,203971,302135
Maldives,MDV,2005,103619,203399,307018
Maldives,MDV,2006,109393,205008,314401
Maldives,MDV,2007,114444,210682,325126
Maldives,MDV,2008,119964,216919,336883
Maldives,MDV,2009,125727,223310,349037
Maldives,MDV,2010,131736,229839,361575
Maldives,MDV,2011,137977,236463,374440
Maldives,MDV,2012,144424,243115,387539
Maldives,MDV,2013,151014,249714,400728
Maldives,MDV,2014,158802,257936,416738
Maldives,MDV,2015,167825,267757,435582
Maldives,MDV,2016,176949,277303,454252
Maldives,MDV,2017,186048,286394,472442
Maldives,MDV,2018,194963,294795,489758
Maldives,MDV,2019,203004,301504,504508
Maldives,MDV,2020,209217,305221,514438
Maldives,MDV,2021,214329,307128,521457
Mali,MLI,1960,591676,4755116,5346792
Mali,MLI,1961,615794,4804453,5420247
Mali,MLI,1962,640809,4854036,5494845
Mali,MLI,1963,666784,4903678,5570462
Mali,MLI,1964,693837,4953543,5647380
Mali,MLI,1965,721982,5004400,5726382
Mali,MLI,1966,751254,5055318,5806572
Mali,MLI,1967,781639,5106858,5888497
Mali,MLI,1968,813567,5160195,5973762
Mali,MLI,1969,846889,5214875,6061764
Mali,MLI,1970,881809,5271778,6153587
Mali,MLI,1971,918251,5329627,6247878
Mali,MLI,1972,956644,5390514,6347158
Mali,MLI,1973,997595,5457662,6455257
Mali,MLI,1974,1040901,5528372,6569273
Mali,MLI,1975,1086284,5601009,6687293
Mali,MLI,1976,1133541,5674107,6807648
Mali,MLI,1977,1184763,5750573,6935336
Mali,MLI,1978,1240593,5832345,7072938
Mali,MLI,1979,1299759,5918320,7218079
Mali,MLI,1980,1362748,6009833,7372581
Mali,MLI,1981,1428984,6103880,7532864
Mali,MLI,1982,1498171,6198178,7696349
Mali,MLI,1983,1570587,6293357,7863944
Mali,MLI,1984,1645207,6384892,8030099
Mali,MLI,1985,1720471,6467180,8187651
Mali,MLI,1986,1795937,6538651,8334588
Mali,MLI,1987,1870200,6604129,8474329
Mali,MLI,1988,1937381,6680093,8617474
Mali,MLI,1989,2009186,6764936,8774122
Mali,MLI,1990,2086159,6858867,8945026
Mali,MLI,1991,2167034,6956935,9123969
Mali,MLI,1992,2251855,7058717,9310572
Mali,MLI,1993,2340883,7165627,9506510
Mali,MLI,1994,2434650,7277147,9711797
Mali,MLI,1995,2531764,7389330,9921094
Mali,MLI,1996,2631763,7500143,10131906
Mali,MLI,1997,2738378,7620923,10359301
Mali,MLI,1998,2862006,7758469,10620475
Mali,MLI,1999,3018112,7898881,10916993
Mali,MLI,2000,3186959,8052142,11239101
Mali,MLI,2001,3367997,8215827,11583824
Mali,MLI,2002,3562610,8390050,11952660
Mali,MLI,2003,3770161,8572004,12342165
Mali,MLI,2004,3991374,8760621,12751995
Mali,MLI,2005,4225685,8954866,13180551
Mali,MLI,2006,4472881,9150660,13623541
Mali,MLI,2007,4732876,9348036,14080912
Mali,MLI,2008,5006021,9545096,14551117
Mali,MLI,2009,5291488,9741147,15032635
Mali,MLI,2010,5590350,9938831,15529181
Mali,MLI,2011,5902462,10137272,16039734
Mali,MLI,2012,6209357,10305330,16514687
Mali,MLI,2013,6529209,10474824,17004033
Mali,MLI,2014,6879609,10672205,17551814
Mali,MLI,2015,7243533,10869374,18112907
Mali,MLI,2016,7626464,11073642,18700106
Mali,MLI,2017,8028117,11283238,19311355
Mali,MLI,2018,8443371,11490927,19934298
Mali,MLI,2019,8871964,11695460,20567424
Mali,MLI,2020,9319264,11904776,21224040
Mali,MLI,2021,9786489,12118494,21904983
Malta,MLT,1960,294316,32234,326550
Malta,MLT,1961,292949,32301,325250
Malta,MLT,1962,291536,32364,323900
Malta,MLT,1963,290127,32423,322550
Malta,MLT,1964,288759,32491,321250
Malta,MLT,1965,286362,32438,318800
Malta,MLT,1966,282936,32264,315200
Malta,MLT,1967,279467,32083,311550
Malta,MLT,1968,276131,31769,307900
Malta,MLT,1969,272927,31373,304300
Malta,MLT,1970,271474,31176,302650
Malta,MLT,1971,271546,31154,302700
Malta,MLT,1972,271346,31104,302450
Malta,MLT,1973,271149,31051,302200
Malta,MLT,1974,270993,31003,301996
Malta,MLT,1975,273015,31207,304222
Malta,MLT,1976,274435,31339,305774
Malta,MLT,1977,275536,31434,306970
Malta,MLT,1978,278444,31738,310182
Malta,MLT,1979,281309,32033,313342
Malta,MLT,1980,284300,32345,316645
Malta,MLT,1981,286427,32555,318982
Malta,MLT,1982,292666,33232,325898
Malta,MLT,1983,296847,33677,330524
Malta,MLT,1984,296939,33654,330593
Malta,MLT,1985,302228,34224,336452
Malta,MLT,1986,307591,34530,342121
Malta,MLT,1987,310133,34352,344485
Malta,MLT,1988,313103,34222,347325
Malta,MLT,1989,316579,34143,350722
Malta,MLT,1990,320102,34068,354170
Malta,MLT,1991,329269,34576,363845
Malta,MLT,1992,333102,34516,367618
Malta,MLT,1993,336862,34446,371308
Malta,MLT,1994,340447,34350,374797
Malta,MLT,1995,343247,34172,377419
Malta,MLT,1996,346401,33504,379905
Malta,MLT,1997,350223,32568,382791
Malta,MLT,1998,353666,31621,385287
Malta,MLT,1999,356901,30677,387578
Malta,MLT,2000,360316,29771,390087
Malta,MLT,2001,364105,28923,393028
Malta,MLT,2002,367875,28094,395969
Malta,MLT,2003,371319,27263,398582
Malta,MLT,2004,374812,26456,401268
Malta,MLT,2005,378170,25664,403834
Malta,MLT,2006,380114,25194,405308
Malta,MLT,2007,381739,24985,406724
Malta,MLT,2008,384526,24853,409379
Malta,MLT,2009,387733,24744,412477
Malta,MLT,2010,389936,24572,414508
Malta,MLT,2011,391879,24389,416268
Malta,MLT,2012,395713,24315,420028
Malta,MLT,2013,401597,24370,425967
Malta,MLT,2014,409992,24566,434558
Malta,MLT,2015,420192,24861,445053
Malta,MLT,2016,430220,25136,455356
Malta,MLT,2017,442474,25525,467999
Malta,MLT,2018,458518,26112,484630
Malta,MLT,2019,477236,26826,504062
Malta,MLT,2020,488246,27086,515332
Malta,MLT,2021,491624,26912,518536
Marshall Islands,MHL,1960,5471,9903,15374
Marshall Islands,MHL,1961,5864,10003,15867
Marshall Islands,MHL,1962,6286,10101,16387
Marshall Islands,MHL,1963,6741,10206,16947
Marshall Islands,MHL,1964,7228,10309,17537
Marshall Islands,MHL,1965,7745,10409,18154
Marshall Islands,MHL,1966,8293,10501,18794
Marshall Islands,MHL,1967,8967,10698,19665
Marshall Islands,MHL,1968,10129,10872,21001
Marshall Islands,MHL,1969,11506,11117,22623
Marshall Islands,MHL,1970,12821,11148,23969
Marshall Islands,MHL,1971,13846,10834,24680
Marshall Islands,MHL,1972,14721,10363,25084
Marshall Islands,MHL,1973,15623,9899,25522
Marshall Islands,MHL,1974,15990,10184,26174
Marshall Islands,MHL,1975,16399,10648,27047
Marshall Islands,MHL,1976,16825,11139,27964
Marshall Islands,MHL,1977,17262,11650,28912
Marshall Islands,MHL,1978,17707,12185,29892
Marshall Islands,MHL,1979,18161,12741,30902
Marshall Islands,MHL,1980,18648,13340,31988
Marshall Islands,MHL,1981,19541,13678,33219
Marshall Islands,MHL,1982,20608,13961,34569
Marshall Islands,MHL,1983,21727,14248,35975
Marshall Islands,MHL,1984,22902,14535,37437
Marshall Islands,MHL,1985,24135,14827,38962
Marshall Islands,MHL,1986,25415,15112,40527
Marshall Islands,MHL,1987,26735,15387,42122
Marshall Islands,MHL,1988,28058,15629,43687
Marshall Islands,MHL,1989,29114,15874,44988
Marshall Islands,MHL,1990,29955,16092,46047
Marshall Islands,MHL,1991,30769,16284,47053
Marshall Islands,MHL,1992,31559,16456,48015
Marshall Islands,MHL,1993,32334,16610,48944
Marshall Islands,MHL,1994,33092,16748,49840
Marshall Islands,MHL,1995,33832,16870,50702
Marshall Islands,MHL,1996,34560,16978,51538
Marshall Islands,MHL,1997,35281,17077,52358
Marshall Islands,MHL,1998,35998,17166,53164
Marshall Islands,MHL,1999,36636,17198,53834
Marshall Islands,MHL,2000,37187,17037,54224
Marshall Islands,MHL,2001,37600,16813,54413
Marshall Islands,MHL,2002,37939,16557,54496
Marshall Islands,MHL,2003,38216,16277,54493
Marshall Islands,MHL,2004,38451,15984,54435
Marshall Islands,MHL,2005,38654,15683,54337
Marshall Islands,MHL,2006,38832,15376,54208
Marshall Islands,MHL,2007,38975,15063,54038
Marshall Islands,MHL,2008,39077,14739,53816
Marshall Islands,MHL,2009,39173,14420,53593
Marshall Islands,MHL,2010,39297,14119,53416
Marshall Islands,MHL,2011,39219,13752,52971
Marshall Islands,MHL,2012,38890,13313,52203
Marshall Islands,MHL,2013,38486,12866,51352
Marshall Islands,MHL,2014,38008,12411,50419
Marshall Islands,MHL,2015,37458,11952,49410
Marshall Islands,MHL,2016,36840,11489,48329
Marshall Islands,MHL,2017,36161,11026,47187
Marshall Islands,MHL,2018,35426,10563,45989
Marshall Islands,MHL,2019,34627,10101,44728
Marshall Islands,MHL,2020,33773,9640,43413
Marshall Islands,MHL,2021,32867,9183,42050
Mauritania,MRT,1960,57687,780791,838478
Mauritania,MRT,1961,64065,797598,861663
Mauritania,MRT,1962,71150,814788,885938
Mauritania,MRT,1963,79018,832272,911290
Mauritania,MRT,1964,87753,850077,937830
Mauritania,MRT,1965,97431,868190,965621
Mauritania,MRT,1966,108163,886534,994697
Mauritania,MRT,1967,120047,904945,1024992
Mauritania,MRT,1968,133169,923224,1056393
Mauritania,MRT,1969,147580,941252,1088832
Mauritania,MRT,1970,163437,958761,1122198
Mauritania,MRT,1971,180809,975552,1156361
Mauritania,MRT,1972,199829,991547,1191376
Mauritania,MRT,1973,220569,1006789,1227358
Mauritania,MRT,1974,243223,1021129,1264352
Mauritania,MRT,1975,267898,1034538,1302436
Mauritania,MRT,1976,294764,1046840,1341604
Mauritania,MRT,1977,322223,1059106,1381329
Mauritania,MRT,1978,350143,1071643,1421786
Mauritania,MRT,1979,380148,1083366,1463514
Mauritania,MRT,1980,412397,1094297,1506694
Mauritania,MRT,1981,447041,1104646,1551687
Mauritania,MRT,1982,484215,1114117,1598332
Mauritania,MRT,1983,523899,1122444,1646343
Mauritania,MRT,1984,566203,1129472,1695675
Mauritania,MRT,1985,611088,1135177,1746265
Mauritania,MRT,1986,658683,1139326,1798009
Mauritania,MRT,1987,709061,1142031,1851092
Mauritania,MRT,1988,754144,1151703,1905847
Mauritania,MRT,1989,771205,1183835,1955040
Mauritania,MRT,1990,788830,1217197,2006027
Mauritania,MRT,1991,809970,1256332,2066302
Mauritania,MRT,1992,839146,1308381,2147527
Mauritania,MRT,1993,871381,1365683,2237064
Mauritania,MRT,1994,898966,1416225,2315191
Mauritania,MRT,1995,921311,1459030,2380341
Mauritania,MRT,1996,937086,1491730,2428816
Mauritania,MRT,1997,955428,1528850,2484278
Mauritania,MRT,1998,977786,1572715,2550501
Mauritania,MRT,1999,1001440,1619171,2620611
Mauritania,MRT,2000,1026554,1668449,2695003
Mauritania,MRT,2001,1066506,1695317,2761823
Mauritania,MRT,2002,1114008,1707695,2821703
Mauritania,MRT,2003,1163451,1719875,2883326
Mauritania,MRT,2004,1214843,1731732,2946575
Mauritania,MRT,2005,1268535,1743825,3012360
Mauritania,MRT,2006,1324867,1756362,3081229
Mauritania,MRT,2007,1384075,1769433,3153508
Mauritania,MRT,2008,1448147,1785189,3233336
Mauritania,MRT,2009,1517970,1804646,3322616
Mauritania,MRT,2010,1593058,1826403,3419461
Mauritania,MRT,2011,1673772,1850477,3524249
Mauritania,MRT,2012,1759879,1876234,3636113
Mauritania,MRT,2013,1845503,1897456,3742959
Mauritania,MRT,2014,1929389,1913785,3843174
Mauritania,MRT,2015,2016084,1930136,3946220
Mauritania,MRT,2016,2105443,1946447,4051890
Mauritania,MRT,2017,2197486,1962529,4160015
Mauritania,MRT,2018,2292177,1978535,4270712
Mauritania,MRT,2019,2389505,1994344,4383849
Mauritania,MRT,2020,2488943,2009661,4498604
Mauritania,MRT,2021,2590523,2024451,4614974
Mauritius,MUS,1960,237590,439093,676683
Mauritius,MUS,1961,243908,436849,680757
Mauritius,MUS,1962,256013,444336,700349
Mauritius,MUS,1963,268035,450826,718861
Mauritius,MUS,1964,280009,456372,736381
Mauritius,MUS,1965,291916,461084,753000
Mauritius,MUS,1966,303804,465009,768813
Mauritius,MUS,1967,315676,468241,783917
Mauritius,MUS,1968,327573,470840,798413
Mauritius,MUS,1969,339504,472901,812405
Mauritius,MUS,1970,351513,474487,826000
Mauritius,MUS,1971,363605,475625,839230
Mauritius,MUS,1972,375755,476298,852053
Mauritius,MUS,1973,379491,485328,864819
Mauritius,MUS,1974,383371,494671,878042
Mauritius,MUS,1975,387512,504488,892000
Mauritius,MUS,1976,391829,514678,906507
Mauritius,MUS,1977,396239,525140,921379
Mauritius,MUS,1978,399416,534083,933499
Mauritius,MUS,1979,404358,545530,949888
Mauritius,MUS,1980,409127,556912,966039
Mauritius,MUS,1981,413108,567354,980462
Mauritius,MUS,1982,416035,576486,992521
Mauritius,MUS,1983,417715,583976,1001691
Mauritius,MUS,1984,425254,586967,1012221
Mauritius,MUS,1985,431938,588590,1020528
Mauritius,MUS,1986,438482,589878,1028360
Mauritius,MUS,1987,445028,591054,1036082
Mauritius,MUS,1988,451399,591840,1043239
Mauritius,MUS,1989,458181,593079,1051260
Mauritius,MUS,1990,464802,593973,1058775
Mauritius,MUS,1991,468530,601736,1070266
Mauritius,MUS,1992,473391,611050,1084441
Mauritius,MUS,1993,477687,619687,1097374
Mauritius,MUS,1994,483053,629793,1112846
Mauritius,MUS,1995,485844,636613,1122457
Mauritius,MUS,1996,489444,644552,1133996
Mauritius,MUS,1997,494198,654086,1148284
Mauritius,MUS,1998,498006,662415,1160421
Mauritius,MUS,1999,502932,672335,1175267
Mauritius,MUS,2000,506439,680434,1186873
Mauritius,MUS,2001,509128,687159,1196287
Mauritius,MUS,2002,511325,693296,1204621
Mauritius,MUS,2003,513680,699690,1213370
Mauritius,MUS,2004,515544,705459,1221003
Mauritius,MUS,2005,517242,711012,1228254
Mauritius,MUS,2006,518278,715718,1233996
Mauritius,MUS,2007,519269,720361,1239630
Mauritius,MUS,2008,519756,724365,1244121
Mauritius,MUS,2009,519754,727675,1247429
Mauritius,MUS,2010,519604,730796,1250400
Mauritius,MUS,2011,519046,733358,1252404
Mauritius,MUS,2012,519081,736801,1255882
Mauritius,MUS,2013,518842,739811,1258653
Mauritius,MUS,2014,518383,742551,1260934
Mauritius,MUS,2015,517668,744937,1262605
Mauritius,MUS,2016,516887,746586,1263473
Mauritius,MUS,2017,516481,748132,1264613
Mauritius,MUS,2018,516155,749148,1265303
Mauritius,MUS,2019,515980,749731,1265711
Mauritius,MUS,2020,515916,749824,1265740
Mauritius,MUS,2021,516236,749824,1266060
Mexico,MEX,1960,18407126,17860928,36268054
Mexico,MEX,1961,19314944,18124372,37439316
Mexico,MEX,1962,20280872,18402412,38683284
Mexico,MEX,1963,21296475,18685644,39982119
Mexico,MEX,1964,22361628,18972250,41333878
Mexico,MEX,1965,23476406,19261584,42737990
Mexico,MEX,1966,24635453,19544984,44180437
Mexico,MEX,1967,25835906,19821056,45656962
Mexico,MEX,1968,27080962,20089376,47170338
Mexico,MEX,1969,28365904,20348490,48714394
Mexico,MEX,1970,29681251,20608056,50289307
Mexico,MEX,1971,31023911,20873764,51897675
Mexico,MEX,1972,32410913,21132524,53543437
Mexico,MEX,1973,33843291,21384912,55228203
Mexico,MEX,1974,35318974,21626906,56945880
Mexico,MEX,1975,36834438,21857444,58691882
Mexico,MEX,1976,38381924,22070620,60452544
Mexico,MEX,1977,39981868,22280636,62262504
Mexico,MEX,1978,41638276,22485720,64123996
Mexico,MEX,1979,43308578,22664334,65972912
Mexico,MEX,1980,44914943,22790244,67705187
Mexico,MEX,1981,46296621,22937148,69233769
Mexico,MEX,1982,47619845,23036938,70656783
Mexico,MEX,1983,48956226,23124084,72080310
Mexico,MEX,1984,50294115,23195540,73489655
Mexico,MEX,1985,51624248,23247758,74872006
Mexico,MEX,1986,52944682,23279684,76224366
Mexico,MEX,1987,54258758,23294746,77553504
Mexico,MEX,1988,55588892,23303124,78892016
Mexico,MEX,1989,56930659,23303090,80233749
Mexico,MEX,1990,58363912,23356516,81720428
Mexico,MEX,1991,59859781,23491814,83351595
Mexico,MEX,1992,61372714,23620450,84993164
Mexico,MEX,1993,62905040,23743408,86648448
Mexico,MEX,1994,64456282,23858142,88314424
Mexico,MEX,1995,66008876,23960696,89969572
Mexico,MEX,1996,67471815,24114740,91586555
Mexico,MEX,1997,68889330,24293764,93183094
Mexico,MEX,1998,70304057,24463228,94767285
Mexico,MEX,1999,71712596,24622214,96334810
Mexico,MEX,2000,73132993,24740448,97873441
Mexico,MEX,2001,74590443,24803844,99394287
Mexico,MEX,2002,76056158,24860924,100917082
Mexico,MEX,2003,77520574,24908768,102429342
Mexico,MEX,2004,78995700,24950112,103945812
Mexico,MEX,2005,80460988,24981414,105442402
Mexico,MEX,2006,81892383,24994408,106886791
Mexico,MEX,2007,83306647,24996326,108302973
Mexico,MEX,2008,84700556,24983932,109684488
Mexico,MEX,2009,86085517,24963912,111049429
Mexico,MEX,2010,87567088,24965312,112532400
Mexico,MEX,2011,89164082,24986400,114150482
Mexico,MEX,2012,90758420,24997488,115755908
Mexico,MEX,2013,92306597,24984088,117290685
Mexico,MEX,2014,93808838,24947048,118755886
Mexico,MEX,2015,95260846,24889052,120149898
Mexico,MEX,2016,96701350,24817872,121519222
Mexico,MEX,2017,98108030,24731228,122839258
Mexico,MEX,2018,99404550,24609312,124013862
Mexico,MEX,2019,100623628,24461684,125085312
Mexico,MEX,2020,101719689,24278612,125998301
Mexico,MEX,2021,102651435,24053704,126705139
Micronesia (country),FSM,1960,9591,33395,42986
Micronesia (country),FSM,1961,10050,34513,44563
Micronesia (country),FSM,1962,10532,35668,46200
Micronesia (country),FSM,1963,11004,36754,47758
Micronesia (country),FSM,1964,11465,37766,49231
Micronesia (country),FSM,1965,11947,38812,50759
Micronesia (country),FSM,1966,12452,39894,52346
Micronesia (country),FSM,1967,12967,40973,53940
Micronesia (country),FSM,1968,13497,42056,55553
Micronesia (country),FSM,1969,14052,43184,57236
Micronesia (country),FSM,1970,14634,44355,58989
Micronesia (country),FSM,1971,15210,45463,60673
Micronesia (country),FSM,1972,15772,46493,62265
Micronesia (country),FSM,1973,16351,47538,63889
Micronesia (country),FSM,1974,16874,48678,65552
Micronesia (country),FSM,1975,17356,49765,67121
Micronesia (country),FSM,1976,17819,50783,68602
Micronesia (country),FSM,1977,18302,51842,70144
Micronesia (country),FSM,1978,18866,53117,71983
Micronesia (country),FSM,1979,19512,54602,74114
Micronesia (country),FSM,1980,20177,56122,76299
Micronesia (country),FSM,1981,20746,57785,78531
Micronesia (country),FSM,1982,21295,59521,80816
Micronesia (country),FSM,1983,21855,61298,83153
Micronesia (country),FSM,1984,22426,63117,85543
Micronesia (country),FSM,1985,23002,64964,87966
Micronesia (country),FSM,1986,23578,66819,90397
Micronesia (country),FSM,1987,24155,68690,92845
Micronesia (country),FSM,1988,24649,70338,94987
Micronesia (country),FSM,1989,25055,71741,96796
Micronesia (country),FSM,1990,25457,73146,98603
Micronesia (country),FSM,1991,25862,74565,100427
Micronesia (country),FSM,1992,26429,76464,102893
Micronesia (country),FSM,1993,27165,78865,106030
Micronesia (country),FSM,1994,27814,81030,108844
Micronesia (country),FSM,1995,27657,82671,110328
Micronesia (country),FSM,1996,27112,83673,110785
Micronesia (country),FSM,1997,26549,84584,111133
Micronesia (country),FSM,1998,25973,85433,111406
Micronesia (country),FSM,1999,25374,86165,111539
Micronesia (country),FSM,2000,24945,86764,111709
Micronesia (country),FSM,2001,24998,86950,111948
Micronesia (country),FSM,2002,25008,86984,111992
Micronesia (country),FSM,2003,24966,86839,111805
Micronesia (country),FSM,2004,24884,86554,111438
Micronesia (country),FSM,2005,24773,86167,110940
Micronesia (country),FSM,2006,24624,85677,110301
Micronesia (country),FSM,2007,24444,85088,109532
Micronesia (country),FSM,2008,24253,84451,108704
Micronesia (country),FSM,2009,24060,83808,107868
Micronesia (country),FSM,2010,23990,83598,107588
Micronesia (country),FSM,2011,24064,83823,107887
Micronesia (country),FSM,2012,24162,84070,108232
Micronesia (country),FSM,2013,24280,84329,108609
Micronesia (country),FSM,2014,24420,84604,109024
Micronesia (country),FSM,2015,24581,84881,109462
Micronesia (country),FSM,2016,24762,85163,109925
Micronesia (country),FSM,2017,24966,85464,110430
Micronesia (country),FSM,2018,25184,85745,110929
Micronesia (country),FSM,2019,25408,85971,111379
Micronesia (country),FSM,2020,25709,86397,112106
Micronesia (country),FSM,2021,26097,87034,113131
Middle East and North Africa (WB),,1960,36622632,68335624,104958256
Middle East and North Africa (WB),,1961,38385899,69284890,107670789
Middle East and North Africa (WB),,1962,40259955,70278050,110538005
Middle East and North Africa (WB),,1963,42232743,71285310,113518053
Middle East and North Africa (WB),,1964,44330115,72294540,116624655
Middle East and North Africa (WB),,1965,46550151,73281840,119831991
Middle East and North Africa (WB),,1966,48809456,74345740,123155196
Middle East and North Africa (WB),,1967,51129040,75549000,126678040
Middle East and North Africa (WB),,1968,53531435,76726680,130258115
Middle East and North Africa (WB),,1969,56057875,77912730,133970605
Middle East and North Africa (WB),,1970,58708392,79102810,137811202
Middle East and North Africa (WB),,1971,61418682,80313730,141732412
Middle East and North Africa (WB),,1972,64237075,81507464,145744539
Middle East and North Africa (WB),,1973,67229976,82734090,149964066
Middle East and North Africa (WB),,1974,70316352,84017680,154334032
Middle East and North Africa (WB),,1975,73587637,85476580,159064217
Middle East and North Africa (WB),,1976,77291621,87173550,164465171
Middle East and North Africa (WB),,1977,81052509,88908296,169960805
Middle East and North Africa (WB),,1978,84455157,90467140,174922297
Middle East and North Africa (WB),,1979,88032538,92122760,180155298
Middle East and North Africa (WB),,1980,92070714,93950970,186021684
Middle East and North Africa (WB),,1981,96541133,96099900,192641033
Middle East and North Africa (WB),,1982,101140434,98278600,199419034
Middle East and North Africa (WB),,1983,105667603,100259490,205927093
Middle East and North Africa (WB),,1984,110379635,102304260,212683895
Middle East and North Africa (WB),,1985,115161292,104361490,219522782
Middle East and North Africa (WB),,1986,120092601,106398170,226490771
Middle East and North Africa (WB),,1987,124941569,108571016,233512585
Middle East and North Africa (WB),,1988,129612945,110815140,240428085
Middle East and North Africa (WB),,1989,134321394,113084730,247406124
Middle East and North Africa (WB),,1990,140070288,116133710,256203998
Middle East and North Africa (WB),,1991,144931486,118514320,263445806
Middle East and North Africa (WB),,1992,150218938,120433310,270652248
Middle East and North Africa (WB),,1993,154902111,121995510,276897621
Middle East and North Africa (WB),,1994,159406565,123497050,282903615
Middle East and North Africa (WB),,1995,163928957,125225980,289154937
Middle East and North Africa (WB),,1996,168452665,126913570,295366235
Middle East and North Africa (WB),,1997,173106008,128574240,301680248
Middle East and North Africa (WB),,1998,177879219,130162400,308041619
Middle East and North Africa (WB),,1999,182753905,131718216,314472121
Middle East and North Africa (WB),,2000,187755039,133282420,321037459
Middle East and North Africa (WB),,2001,192854627,134837020,327691647
Middle East and North Africa (WB),,2002,197697731,136251840,333949571
Middle East and North Africa (WB),,2003,202561806,137653550,340215356
Middle East and North Africa (WB),,2004,207835182,139209740,347044922
Middle East and North Africa (WB),,2005,213719274,140743100,354462374
Middle East and North Africa (WB),,2006,220272056,142361940,362633996
Middle East and North Africa (WB),,2007,227159256,144165550,371324806
Middle East and North Africa (WB),,2008,234297106,145997000,380294106
Middle East and North Africa (WB),,2009,241543564,147788800,389332364
Middle East and North Africa (WB),,2010,248421309,149576260,397997569
Middle East and North Africa (WB),,2011,254476115,151569220,406045335
Middle East and North Africa (WB),,2012,260609701,153507900,414117601
Middle East and North Africa (WB),,2013,267522878,155267540,422790418
Middle East and North Africa (WB),,2014,274769467,156895100,431664567
Middle East and North Africa (WB),,2015,282176862,158329620,440506482
Middle East and North Africa (WB),,2016,289100440,159816980,448917420
Middle East and North Africa (WB),,2017,295656568,161228910,456885478
Middle East and North Africa (WB),,2018,302396489,162677010,465073499
Middle East and North Africa (WB),,2019,309063077,164138700,473201777
Middle East and North Africa (WB),,2020,314666352,165300300,479966652
Middle East and North Africa (WB),,2021,319928723,166238640,486167363
Middle-income countries,,1960,504468804,1596046700,2100515504
Middle-income countries,,1961,521873499,1606176000,2128049499
Middle-income countries,,1962,542272665,1626418600,2168691265
Middle-income countries,,1963,565384549,1656054000,2221438549
Middle-income countries,,1964,589213717,1685246100,2274459817
Middle-income countries,,1965,608300956,1720060000,2328360956
Middle-income countries,,1966,628186269,1756926700,2385112969
Middle-income countries,,1967,648630522,1793009200,2441639722
Middle-income countries,,1968,669785758,1830167700,2499953458
Middle-income countries,,1969,691692391,1868977400,2560669791
Middle-income countries,,1970,714148212,1908399000,2622547212
Middle-income countries,,1971,737624042,1947132200,2684756242
Middle-income countries,,1972,762133177,1984040700,2746173877
Middle-income countries,,1973,788196937,2020286100,2808483037
Middle-income countries,,1974,815723334,2054446300,2870169634
Middle-income countries,,1975,841824124,2088362800,2930186924
Middle-income countries,,1976,869954835,2119650700,2989605535
Middle-income countries,,1977,898567955,2150236200,3048804155
Middle-income countries,,1978,930705472,2177948700,3108654172
Middle-income countries,,1979,966715840,2203176200,3169892040
Middle-income countries,,1980,1004292669,2228827600,3233120269
Middle-income countries,,1981,1043625025,2255265800,3298890825
Middle-income countries,,1982,1083255812,2283966200,3367222012
Middle-income countries,,1983,1122220903,2313434600,3435655503
Middle-income countries,,1984,1162322125,2341485600,3503807725
Middle-income countries,,1985,1203601547,2369775900,3573377447
Middle-income countries,,1986,1246272125,2398962000,3645234125
Middle-income countries,,1987,1290183938,2428871200,3719055138
Middle-income countries,,1988,1334954847,2458471700,3793426547
Middle-income countries,,1989,1379675126,2487370800,3867045926
Middle-income countries,,1990,1425919389,2516479200,3942398589
Middle-income countries,,1991,1471576521,2543273500,4014850021
Middle-income countries,,1992,1516582196,2567476200,4084058396
Middle-income countries,,1993,1561585040,2590181400,4151766440
Middle-income countries,,1994,1607382429,2612178000,4219560429
Middle-income countries,,1995,1653690146,2633145600,4286835746
Middle-income countries,,1996,1700666028,2652969500,4353635528
Middle-income countries,,1997,1748474981,2671890400,4420365381
Middle-income countries,,1998,1796989688,2689659600,4486649288
Middle-income countries,,1999,1845692538,2705862700,4551555238
Middle-income countries,,2000,1895316738,2720734200,4616050938
Middle-income countries,,2001,1947961408,2732182800,4680144208
Middle-income countries,,2002,2002920920,2739417300,4742338220
Middle-income countries,,2003,2058590284,2744788000,4803378284
Middle-income countries,,2004,2115494397,2749138000,4864632397
Middle-income countries,,2005,2173269404,2752171500,4925440904
Middle-income countries,,2006,2230743230,2754060500,4984803730
Middle-income countries,,2007,2288376020,2755068400,5043444420
Middle-income countries,,2008,2347352853,2755501600,5102854453
Middle-income countries,,2009,2407583395,2755609000,5163192395
Middle-income countries,,2010,2468821230,2755703600,5224524830
Middle-income countries,,2011,2530420623,2757250000,5287670623
Middle-income countries,,2012,2593477682,2759360000,5352837682
Middle-income countries,,2013,2658459290,2760925000,5419384290
Middle-income countries,,2014,2724612368,2761234000,5485846368
Middle-income countries,,2015,2790704083,2760203800,5550907883
Middle-income countries,,2016,2856275534,2758211800,5614487334
Middle-income countries,,2017,2922044655,2755539700,5677584355
Middle-income countries,,2018,2986976031,2751242800,5738218831
Middle-income countries,,2019,3050712892,2745325800,5796038692
Middle-income countries,,2020,3112602346,2738011100,5850613446
Middle-income countries,,2021,3171431812,2728106000,5899537812
Moldova,MDA,1960,485817,1588198,2074015
Moldova,MDA,1961,515281,1612573,2127854
Moldova,MDA,1962,545007,1632669,2177676
Moldova,MDA,1963,574695,1647980,2222675
Moldova,MDA,1964,604679,1659782,2264461
Moldova,MDA,1965,634411,1667014,2301425
Moldova,MDA,1966,664744,1672038,2336782
Moldova,MDA,1967,695397,1674332,2369729
Moldova,MDA,1968,726320,1673944,2400264
Moldova,MDA,1969,757641,1671552,2429193
Moldova,MDA,1970,787755,1668759,2456514
Moldova,MDA,1971,816396,1666636,2483032
Moldova,MDA,1972,845743,1663807,2509550
Moldova,MDA,1973,875730,1660338,2536068
Moldova,MDA,1974,906722,1656667,2563389
Moldova,MDA,1975,938407,1652304,2590711
Moldova,MDA,1976,970819,1647213,2618032
Moldova,MDA,1977,1003249,1640497,2643746
Moldova,MDA,1978,1036026,1632631,2668657
Moldova,MDA,1979,1067412,1625352,2692764
Moldova,MDA,1980,1096938,1619130,2716068
Moldova,MDA,1981,1127198,1612977,2740175
Moldova,MDA,1982,1158659,1607230,2765889
Moldova,MDA,1983,1190934,1601473,2792407
Moldova,MDA,1984,1224100,1595628,2819728
Moldova,MDA,1985,1257713,1589337,2847050
Moldova,MDA,1986,1292219,1582956,2875175
Moldova,MDA,1987,1327949,1576958,2904907
Moldova,MDA,1988,1362760,1568664,2931424
Moldova,MDA,1989,1383338,1568979,2952317
Moldova,MDA,1990,1386951,1579027,2965978
Moldova,MDA,1991,1387567,1585643,2973210
Moldova,MDA,1992,1385895,1589726,2975621
Moldova,MDA,1993,1382725,1592092,2974817
Moldova,MDA,1994,1376574,1591011,2967585
Moldova,MDA,1995,1367154,1586046,2953200
Moldova,MDA,1996,1361649,1585644,2947293
Moldova,MDA,1997,1344789,1591624,2936413
Moldova,MDA,1998,1332417,1602810,2935227
Moldova,MDA,1999,1318545,1612077,2930622
Moldova,MDA,2000,1304080,1620588,2924668
Moldova,MDA,2001,1289495,1628640,2918135
Moldova,MDA,2002,1274866,1636519,2911385
Moldova,MDA,2003,1259669,1643529,2903198
Moldova,MDA,2004,1245000,1651023,2896023
Moldova,MDA,2005,1235763,1653222,2888985
Moldova,MDA,2006,1231441,1649526,2880967
Moldova,MDA,2007,1227699,1646600,2874299
Moldova,MDA,2008,1224475,1644358,2868833
Moldova,MDA,2009,1222042,1643171,2865213
Moldova,MDA,2010,1219935,1642419,2862354
Moldova,MDA,2011,1218343,1642356,2860699
Moldova,MDA,2012,1217297,1643027,2860324
Moldova,MDA,2013,1216084,1643474,2859558
Moldova,MDA,2014,1214457,1643358,2857815
Moldova,MDA,2015,1205007,1630971,2835978
Moldova,MDA,2016,1191662,1611524,2803186
Moldova,MDA,2017,1172526,1582663,2755189
Moldova,MDA,2018,1154054,1553149,2707203
Moldova,MDA,2019,1138316,1525908,2664224
Moldova,MDA,2020,1129127,1506003,2635130
Moldova,MDA,2021,1124483,1490716,2615199
Monaco,MCO,1960,21797,0,21797
Monaco,MCO,1961,21907,0,21907
Monaco,MCO,1962,22106,0,22106
Monaco,MCO,1963,22442,0,22442
Monaco,MCO,1964,22766,0,22766
Monaco,MCO,1965,23022,0,23022
Monaco,MCO,1966,23198,0,23198
Monaco,MCO,1967,23281,0,23281
Monaco,MCO,1968,23481,0,23481
Monaco,MCO,1969,23875,0,23875
Monaco,MCO,1970,24270,0,24270
Monaco,MCO,1971,24610,0,24610
Monaco,MCO,1972,24889,0,24889
Monaco,MCO,1973,25102,0,25102
Monaco,MCO,1974,25262,0,25262
Monaco,MCO,1975,25524,0,25524
Monaco,MCO,1976,25898,0,25898
Monaco,MCO,1977,26242,0,26242
Monaco,MCO,1978,26553,0,26553
Monaco,MCO,1979,26834,0,26834
Monaco,MCO,1980,27076,0,27076
Monaco,MCO,1981,27284,0,27284
Monaco,MCO,1982,27573,0,27573
Monaco,MCO,1983,27985,0,27985
Monaco,MCO,1984,28407,0,28407
Monaco,MCO,1985,28807,0,28807
Monaco,MCO,1986,29171,0,29171
Monaco,MCO,1987,29500,0,29500
Monaco,MCO,1988,29802,0,29802
Monaco,MCO,1989,30078,0,30078
Monaco,MCO,1990,30329,0,30329
Monaco,MCO,1991,30564,0,30564
Monaco,MCO,1992,30794,0,30794
Monaco,MCO,1993,31024,0,31024
Monaco,MCO,1994,31253,0,31253
Monaco,MCO,1995,31482,0,31482
Monaco,MCO,1996,31719,0,31719
Monaco,MCO,1997,31968,0,31968
Monaco,MCO,1998,32209,0,32209
Monaco,MCO,1999,32394,0,32394
Monaco,MCO,2000,32465,0,32465
Monaco,MCO,2001,32444,0,32444
Monaco,MCO,2002,32386,0,32386
Monaco,MCO,2003,32316,0,32316
Monaco,MCO,2004,32236,0,32236
Monaco,MCO,2005,32141,0,32141
Monaco,MCO,2006,32011,0,32011
Monaco,MCO,2007,31823,0,31823
Monaco,MCO,2008,31862,0,31862
Monaco,MCO,2009,32401,0,32401
Monaco,MCO,2010,33178,0,33178
Monaco,MCO,2011,33945,0,33945
Monaco,MCO,2012,34700,0,34700
Monaco,MCO,2013,35425,0,35425
Monaco,MCO,2014,36110,0,36110
Monaco,MCO,2015,36760,0,36760
Monaco,MCO,2016,37071,0,37071
Monaco,MCO,2017,37044,0,37044
Monaco,MCO,2018,37029,0,37029
Monaco,MCO,2019,37034,0,37034
Monaco,MCO,2020,36922,0,36922
Monaco,MCO,2021,36686,0,36686
Mongolia,MNG,1960,348906,628997,977903
Mongolia,MNG,1961,381154,630348,1011502
Mongolia,MNG,1962,415304,630011,1045315
Mongolia,MNG,1963,441717,634171,1075888
Mongolia,MNG,1964,459105,644912,1104017
Mongolia,MNG,1965,477603,656469,1134072
Mongolia,MNG,1966,497156,668590,1165746
Mongolia,MNG,1967,517393,680804,1198197
Mongolia,MNG,1968,537897,692509,1230406
Mongolia,MNG,1969,559470,702417,1261887
Mongolia,MNG,1970,582919,710961,1293880
Mongolia,MNG,1971,607725,720056,1327781
Mongolia,MNG,1972,634061,729774,1363835
Mongolia,MNG,1973,662044,740265,1402309
Mongolia,MNG,1974,691736,751394,1443130
Mongolia,MNG,1975,722878,762813,1485691
Mongolia,MNG,1976,755077,774007,1529084
Mongolia,MNG,1977,787878,784638,1572516
Mongolia,MNG,1978,821297,794571,1615868
Mongolia,MNG,1979,853387,804061,1657448
Mongolia,MNG,1980,884255,813525,1697780
Mongolia,MNG,1981,916152,823069,1739221
Mongolia,MNG,1982,949128,832669,1781797
Mongolia,MNG,1983,983361,842412,1825773
Mongolia,MNG,1984,1019152,852500,1871652
Mongolia,MNG,1985,1056627,863117,1919744
Mongolia,MNG,1986,1095823,874089,1969912
Mongolia,MNG,1987,1136387,885115,2021502
Mongolia,MNG,1988,1177902,895869,2073771
Mongolia,MNG,1989,1210524,910301,2120825
Mongolia,MNG,1990,1232730,928703,2161433
Mongolia,MNG,1991,1253758,946319,2200077
Mongolia,MNG,1992,1273504,962990,2236494
Mongolia,MNG,1993,1291716,978595,2270311
Mongolia,MNG,1994,1308431,993079,2301510
Mongolia,MNG,1995,1323746,1006588,2330334
Mongolia,MNG,1996,1337852,1019181,2357033
Mongolia,MNG,1997,1350798,1030973,2381771
Mongolia,MNG,1998,1362973,1042175,2405148
Mongolia,MNG,1999,1375083,1053405,2428488
Mongolia,MNG,2000,1400318,1050661,2450979
Mongolia,MNG,2001,1439598,1033003,2472601
Mongolia,MNG,2002,1479408,1015209,2494617
Mongolia,MNG,2003,1519385,997069,2516454
Mongolia,MNG,2004,1559392,978557,2537949
Mongolia,MNG,2005,1599381,959874,2559255
Mongolia,MNG,2006,1639992,941250,2581242
Mongolia,MNG,2007,1682307,923336,2605643
Mongolia,MNG,2008,1727329,906558,2633887
Mongolia,MNG,2009,1775498,891215,2666713
Mongolia,MNG,2010,1826012,876508,2702520
Mongolia,MNG,2011,1864863,879075,2743938
Mongolia,MNG,2012,1899635,892714,2792349
Mongolia,MNG,2013,1937464,907689,2845153
Mongolia,MNG,2014,1978651,924172,2902823
Mongolia,MNG,2015,2022848,941901,2964749
Mongolia,MNG,2016,2069095,960460,3029555
Mongolia,MNG,2017,2116539,979491,3096030
Mongolia,MNG,2018,2165594,998397,3163991
Mongolia,MNG,2019,2215604,1016826,3232430
Mongolia,MNG,2020,2261792,1032543,3294335
Mongolia,MNG,2021,2302772,1045010,3347782
Montenegro,MNE,1960,90291,390288,480579
Montenegro,MNE,1961,95782,395358,491140
Montenegro,MNE,1962,101703,400855,502558
Montenegro,MNE,1963,107780,405629,513409
Montenegro,MNE,1964,113586,408167,521753
Montenegro,MNE,1965,118771,407556,526327
Montenegro,MNE,1966,123093,403326,526419
Montenegro,MNE,1967,126621,396175,522796
Montenegro,MNE,1968,129779,387702,517481
Montenegro,MNE,1969,133237,380103,513340
Montenegro,MNE,1970,137597,374810,512407
Montenegro,MNE,1971,143135,372314,515449
Montenegro,MNE,1972,149784,372001,521785
Montenegro,MNE,1973,157258,372962,530220
Montenegro,MNE,1974,165076,373826,538902
Montenegro,MNE,1975,172810,373677,546487
Montenegro,MNE,1976,180301,372261,552562
Montenegro,MNE,1977,187635,369941,557576
Montenegro,MNE,1978,194980,367085,562065
Montenegro,MNE,1979,202628,364260,566888
Montenegro,MNE,1980,210794,361814,572608
Montenegro,MNE,1981,219563,359882,579445
Montenegro,MNE,1982,228836,358165,587001
Montenegro,MNE,1983,238326,356180,594506
Montenegro,MNE,1984,247588,353296,600884
Montenegro,MNE,1985,256235,349163,605398
Montenegro,MNE,1986,264087,343624,607711
Montenegro,MNE,1987,271196,336948,608144
Montenegro,MNE,1988,277825,329588,607413
Montenegro,MNE,1989,284397,322174,606571
Montenegro,MNE,1990,291283,315089,606372
Montenegro,MNE,1991,298483,308622,607105
Montenegro,MNE,1992,305585,302931,608516
Montenegro,MNE,1993,312816,297354,610170
Montenegro,MNE,1994,319860,291529,611389
Montenegro,MNE,1995,326440,285272,611712
Montenegro,MNE,1996,332459,278544,611003
Montenegro,MNE,1997,337985,271535,609520
Montenegro,MNE,1998,343256,264406,607662
Montenegro,MNE,1999,348560,257441,606001
Montenegro,MNE,2000,354162,250788,604950
Montenegro,MNE,2001,361755,245634,607389
Montenegro,MNE,2002,369361,240467,609828
Montenegro,MNE,2003,376961,235306,612267
Montenegro,MNE,2004,381058,232295,613353
Montenegro,MNE,2005,383698,230563,614261
Montenegro,MNE,2006,386254,228771,615025
Montenegro,MNE,2007,388857,227018,615875
Montenegro,MNE,2008,391621,225348,616969
Montenegro,MNE,2009,394521,223773,618294
Montenegro,MNE,2010,397301,222127,619428
Montenegro,MNE,2011,399777,220302,620079
Montenegro,MNE,2012,402174,218427,620601
Montenegro,MNE,2013,404636,216571,621207
Montenegro,MNE,2014,407105,214705,621810
Montenegro,MNE,2015,409418,212741,622159
Montenegro,MNE,2016,411597,210706,622303
Montenegro,MNE,2017,413735,208638,622373
Montenegro,MNE,2018,415729,206498,622227
Montenegro,MNE,2019,417692,204336,622028
Montenegro,MNE,2020,419307,201999,621306
Montenegro,MNE,2021,419986,199225,619211
Morocco,MAR,1960,3455253,8314521,11769774
Morocco,MAR,1961,3606271,8475442,12081713
Morocco,MAR,1962,3764224,8640533,12404757
Morocco,MAR,1963,3925674,8801012,12726686
Morocco,MAR,1964,4089765,8954489,13044254
Morocco,MAR,1965,4263735,9118145,13381880
Morocco,MAR,1966,4448115,9290387,13738502
Morocco,MAR,1967,4641545,9468210,14109755
Morocco,MAR,1968,4842439,9647638,14490077
Morocco,MAR,1969,5050140,9826842,14876982
Morocco,MAR,1970,5266138,10008213,15274351
Morocco,MAR,1971,5488936,10188364,15677300
Morocco,MAR,1972,5737053,10344385,16081438
Morocco,MAR,1973,5993751,10495701,16489452
Morocco,MAR,1974,6258783,10643600,16902383
Morocco,MAR,1975,6534073,10791252,17325325
Morocco,MAR,1976,6819390,10937126,17756516
Morocco,MAR,1977,7118548,11087924,18206472
Morocco,MAR,1978,7434210,11245649,18679859
Morocco,MAR,1979,7763286,11404375,19167661
Morocco,MAR,1980,8109487,11568957,19678444
Morocco,MAR,1981,8471303,11736957,20208260
Morocco,MAR,1982,8845176,11901589,20746765
Morocco,MAR,1983,9227441,12059940,21287381
Morocco,MAR,1984,9613344,12203927,21817271
Morocco,MAR,1985,10001424,12333653,22335077
Morocco,MAR,1986,10384666,12439780,22824446
Morocco,MAR,1987,10759753,12520182,23279935
Morocco,MAR,1988,11135157,12585433,23720590
Morocco,MAR,1989,11510435,12637669,24148104
Morocco,MAR,1990,11890063,12680751,24570814
Morocco,MAR,1991,12273397,12714686,24988083
Morocco,MAR,1992,12660713,12739963,25400676
Morocco,MAR,1993,13050229,12756548,25806777
Morocco,MAR,1994,13440086,12761465,26201551
Morocco,MAR,1995,13749580,12849468,26599048
Morocco,MAR,1996,14045468,12953625,26999093
Morocco,MAR,1997,14342391,13054727,27397118
Morocco,MAR,1998,14640178,13151647,27791825
Morocco,MAR,1999,14935781,13241216,28176997
Morocco,MAR,2000,15229497,13324918,28554415
Morocco,MAR,2001,15524469,13405628,28930097
Morocco,MAR,2002,15820051,13481766,29301817
Morocco,MAR,2003,16111112,13550158,29661270
Morocco,MAR,2004,16411301,13621824,30033125
Morocco,MAR,2005,16790498,13641404,30431902
Morocco,MAR,2006,17188176,13644846,30833022
Morocco,MAR,2007,17589282,13643351,31232633
Morocco,MAR,2008,17995882,13639110,31634992
Morocco,MAR,2009,18409274,13633603,32042877
Morocco,MAR,2010,18835465,13629400,32464865
Morocco,MAR,2011,19275316,13628383,32903699
Morocco,MAR,2012,19725140,13627029,33352169
Morocco,MAR,2013,20180706,13622821,33803527
Morocco,MAR,2014,20636838,13611765,34248603
Morocco,MAR,2015,21088840,13591618,34680458
Morocco,MAR,2016,21541817,13565447,35107264
Morocco,MAR,2017,21994745,13533370,35528115
Morocco,MAR,2018,22437808,13489703,35927511
Morocco,MAR,2019,22869599,13434809,36304408
Morocco,MAR,2020,23309111,13379661,36688772
Morocco,MAR,2021,23753114,13323470,37076584
Mozambique,MOZ,1960,466226,6322149,6788375
Mozambique,MOZ,1961,487754,6429767,6917521
Mozambique,MOZ,1962,511595,6548781,7060376
Mozambique,MOZ,1963,536770,6673037,7209807
Mozambique,MOZ,1964,563318,6800321,7363639
Mozambique,MOZ,1965,591399,6932755,7524154
Mozambique,MOZ,1966,620939,7068704,7689643
Mozambique,MOZ,1967,652022,7207449,7859471
Mozambique,MOZ,1968,684788,7350741,8035529
Mozambique,MOZ,1969,719315,7498615,8217930
Mozambique,MOZ,1970,756210,7655466,8411676
Mozambique,MOZ,1971,801756,7821134,8622890
Mozambique,MOZ,1972,856907,8003678,8860585
Mozambique,MOZ,1973,917476,8206192,9123668
Mozambique,MOZ,1974,983305,8420916,9404221
Mozambique,MOZ,1975,1054699,8649033,9703732
Mozambique,MOZ,1976,1131870,8887340,10019210
Mozambique,MOZ,1977,1216580,9146995,10363575
Mozambique,MOZ,1978,1310095,9431033,10741128
Mozambique,MOZ,1979,1409787,9718057,11127844
Mozambique,MOZ,1980,1501800,9911787,11413587
Mozambique,MOZ,1981,1635539,10004476,11640015
Mozambique,MOZ,1982,1789440,10112387,11901827
Mozambique,MOZ,1983,1955133,10208195,12163328
Mozambique,MOZ,1984,2133831,10292392,12426223
Mozambique,MOZ,1985,2323749,10356316,12680065
Mozambique,MOZ,1986,2522703,10387094,12909797
Mozambique,MOZ,1987,2698622,10266171,12964793
Mozambique,MOZ,1988,2870184,10086588,12956772
Mozambique,MOZ,1989,3081476,10006128,13087604
Mozambique,MOZ,1990,3325865,9977594,13303459
Mozambique,MOZ,1991,3456337,10104838,13561175
Mozambique,MOZ,1992,3589626,10227255,13816881
Mozambique,MOZ,1993,3761674,10444580,14206254
Mozambique,MOZ,1994,4024090,10888783,14912873
Mozambique,MOZ,1995,4287799,11307031,15594830
Mozambique,MOZ,1996,4504365,11575188,16079553
Mozambique,MOZ,1997,4714474,11807250,16521724
Mozambique,MOZ,1998,4864065,12059130,16923195
Mozambique,MOZ,1999,5014119,12323774,17337893
Mozambique,MOZ,2000,5170280,12598225,17768505
Mozambique,MOZ,2001,5334479,12886237,18220716
Mozambique,MOZ,2002,5506970,13187976,18694946
Mozambique,MOZ,2003,5686378,13500376,19186754
Mozambique,MOZ,2004,5872479,13821932,19694411
Mozambique,MOZ,2005,6063132,14147982,20211114
Mozambique,MOZ,2006,6258534,14477448,20735982
Mozambique,MOZ,2007,6461615,14818898,21280513
Mozambique,MOZ,2008,6735426,15110145,21845571
Mozambique,MOZ,2009,7028957,15407703,22436660
Mozambique,MOZ,2010,7344366,15729357,23073723
Mozambique,MOZ,2011,7683170,16077251,23760421
Mozambique,MOZ,2012,8043201,16444410,24487611
Mozambique,MOZ,2013,8423977,16827754,25251731
Mozambique,MOZ,2014,8821392,17217312,26038704
Mozambique,MOZ,2015,9234077,17609168,26843245
Mozambique,MOZ,2016,9673277,18023216,27696493
Mozambique,MOZ,2017,10129295,18440146,28569441
Mozambique,MOZ,2018,10589065,18834812,29423877
Mozambique,MOZ,2019,11062722,19222872,30285594
Mozambique,MOZ,2020,11559020,19619220,31178240
Mozambique,MOZ,2021,12069961,20007112,32077073
Myanmar,MMR,1960,4176021,17544676,21720697
Myanmar,MMR,1961,4344260,17858848,22203108
Myanmar,MMR,1962,4519511,18180192,22699703
Myanmar,MMR,1963,4702253,18508434,23210687
Myanmar,MMR,1964,4893076,18844742,23737818
Myanmar,MMR,1965,5093201,19193676,24286877
Myanmar,MMR,1966,5302503,19552200,24854703
Myanmar,MMR,1967,5520741,19919288,25440029
Myanmar,MMR,1968,5748717,20295394,26044111
Myanmar,MMR,1969,5984786,20674692,26659478
Myanmar,MMR,1970,6228963,21055148,27284111
Myanmar,MMR,1971,6480456,21434496,27914952
Myanmar,MMR,1972,6739973,21811976,28551949
Myanmar,MMR,1973,6971395,22193960,29165355
Myanmar,MMR,1974,7114580,22637356,29751936
Myanmar,MMR,1975,7258958,23085318,30344276
Myanmar,MMR,1976,7405199,23536176,30941375
Myanmar,MMR,1977,7554802,23999796,31554598
Myanmar,MMR,1978,7709095,24476506,32185601
Myanmar,MMR,1979,7864755,24957024,32821779
Myanmar,MMR,1980,8022752,25443028,33465780
Myanmar,MMR,1981,8180284,25929814,34110098
Myanmar,MMR,1982,8335789,26406796,34742585
Myanmar,MMR,1983,8516701,26907560,35424261
Myanmar,MMR,1984,8755020,27404818,36159838
Myanmar,MMR,1985,8991961,27889060,36881021
Myanmar,MMR,1986,9224761,28347580,37572341
Myanmar,MMR,1987,9452769,28780402,38233171
Myanmar,MMR,1988,9676644,29191626,38868270
Myanmar,MMR,1989,9899602,29589816,39489418
Myanmar,MMR,1990,10122330,29977224,40099554
Myanmar,MMR,1991,10340178,30340356,40680534
Myanmar,MMR,1992,10553993,30683820,41237813
Myanmar,MMR,1993,10768428,31019874,41788302
Myanmar,MMR,1994,10984786,31352324,42337110
Myanmar,MMR,1995,11202020,31678166,42880186
Myanmar,MMR,1996,11421649,32001720,43423369
Myanmar,MMR,1997,11644677,32327368,43972045
Myanmar,MMR,1998,11869350,32646836,44516186
Myanmar,MMR,1999,12090526,32951110,45041636
Myanmar,MMR,2000,12306734,33231598,45538332
Myanmar,MMR,2001,12519714,33495112,46014826
Myanmar,MMR,2002,12731400,33748830,46480230
Myanmar,MMR,2003,12939374,33984920,46924294
Myanmar,MMR,2004,13141153,34197292,47338445
Myanmar,MMR,2005,13337081,34387390,47724471
Myanmar,MMR,2006,13528193,34560080,48088273
Myanmar,MMR,2007,13719323,34726324,48445647
Myanmar,MMR,2008,13891315,34838172,48729487
Myanmar,MMR,2009,14065094,34950744,49015838
Myanmar,MMR,2010,14266587,35124400,49390987
Myanmar,MMR,2011,14477757,35316764,49794521
Myanmar,MMR,2012,14696854,35521332,50218186
Myanmar,MMR,2013,14919480,35728856,50648336
Myanmar,MMR,2014,15142977,35929460,51072437
Myanmar,MMR,2015,15372077,36111870,51483947
Myanmar,MMR,2016,15610256,36282092,51892348
Myanmar,MMR,2017,15854871,36433470,52288341
Myanmar,MMR,2018,16104740,36561270,52666010
Myanmar,MMR,2019,16363966,36676250,53040216
Myanmar,MMR,2020,16636518,36786680,53423198
Myanmar,MMR,2021,16918421,36879664,53798085
Namibia,NAM,1960,105696,484485,590181
Namibia,NAM,1961,110265,491159,601424
Namibia,NAM,1962,115077,498731,613808
Namibia,NAM,1963,120265,507093,627358
Namibia,NAM,1964,125843,516211,642054
Namibia,NAM,1965,131808,526079,657887
Namibia,NAM,1966,138189,536629,674818
Namibia,NAM,1967,145051,548012,693063
Namibia,NAM,1968,152367,560060,712427
Namibia,NAM,1969,160149,572732,732881
Namibia,NAM,1970,168186,586281,754467
Namibia,NAM,1971,175282,601713,776995
Namibia,NAM,1972,182771,617839,800610
Namibia,NAM,1973,190556,634362,824918
Namibia,NAM,1974,198700,651391,850091
Namibia,NAM,1975,207318,669254,876572
Namibia,NAM,1976,215801,686039,901840
Namibia,NAM,1977,224211,701898,926109
Namibia,NAM,1978,230730,711293,942023
Namibia,NAM,1979,237208,720126,957334
Namibia,NAM,1980,244643,731351,975994
Namibia,NAM,1981,250354,737040,987394
Namibia,NAM,1982,257524,747996,1005520
Namibia,NAM,1983,267166,765919,1033085
Namibia,NAM,1984,277319,784676,1061995
Namibia,NAM,1985,288262,805049,1093311
Namibia,NAM,1986,300282,827707,1127989
Namibia,NAM,1987,313233,852197,1165430
Namibia,NAM,1988,327789,880160,1207949
Namibia,NAM,1989,352867,935203,1288070
Namibia,NAM,1990,378614,990397,1369011
Namibia,NAM,1991,395226,1020391,1415617
Namibia,NAM,1992,414184,1047503,1461687
Namibia,NAM,1993,435179,1074655,1509834
Namibia,NAM,1994,456875,1101574,1558449
Namibia,NAM,1995,478609,1126761,1605370
Namibia,NAM,1996,500234,1149832,1650066
Namibia,NAM,1997,521908,1171334,1693242
Namibia,NAM,1998,543961,1191992,1735953
Namibia,NAM,1999,566399,1211878,1778277
Namibia,NAM,2000,588911,1230230,1819141
Namibia,NAM,2001,610719,1245683,1856402
Namibia,NAM,2002,637679,1250846,1888525
Namibia,NAM,2003,664825,1250600,1915425
Namibia,NAM,2004,691709,1247697,1939406
Namibia,NAM,2005,719037,1243828,1962865
Namibia,NAM,2006,747144,1239414,1986558
Namibia,NAM,2007,776396,1235096,2011492
Namibia,NAM,2008,807205,1231347,2038552
Namibia,NAM,2009,839596,1228323,2067919
Namibia,NAM,2010,873633,1225638,2099271
Namibia,NAM,2011,909166,1223174,2132340
Namibia,NAM,2012,947033,1220437,2167470
Namibia,NAM,2013,986650,1217860,2204510
Namibia,NAM,2014,1027878,1215123,2243001
Namibia,NAM,2015,1070588,1212116,2282704
Namibia,NAM,2016,1114303,1209049,2323352
Namibia,NAM,2017,1158740,1205794,2364534
Namibia,NAM,2018,1203610,1202070,2405680
Namibia,NAM,2019,1248816,1197828,2446644
Namibia,NAM,2020,1295152,1193946,2489098
Namibia,NAM,2021,1341107,1189044,2530151
Nauru,NRU,1960,4582,0,4582
Nauru,NRU,1961,4753,0,4753
Nauru,NRU,1962,4950,0,4950
Nauru,NRU,1963,5198,0,5198
Nauru,NRU,1964,5484,0,5484
Nauru,NRU,1965,5804,0,5804
Nauru,NRU,1966,6021,0,6021
Nauru,NRU,1967,6114,0,6114
Nauru,NRU,1968,6288,0,6288
Nauru,NRU,1969,6508,0,6508
Nauru,NRU,1970,6663,0,6663
Nauru,NRU,1971,6778,0,6778
Nauru,NRU,1972,6883,0,6883
Nauru,NRU,1973,6990,0,6990
Nauru,NRU,1974,7096,0,7096
Nauru,NRU,1975,7199,0,7199
Nauru,NRU,1976,7306,0,7306
Nauru,NRU,1977,7441,0,7441
Nauru,NRU,1978,7541,0,7541
Nauru,NRU,1979,7586,0,7586
Nauru,NRU,1980,7635,0,7635
Nauru,NRU,1981,7691,0,7691
Nauru,NRU,1982,7672,0,7672
Nauru,NRU,1983,7832,0,7832
Nauru,NRU,1984,8125,0,8125
Nauru,NRU,1985,8313,0,8313
Nauru,NRU,1986,8527,0,8527
Nauru,NRU,1987,8759,0,8759
Nauru,NRU,1988,9022,0,9022
Nauru,NRU,1989,9306,0,9306
Nauru,NRU,1990,9598,0,9598
Nauru,NRU,1991,9902,0,9902
Nauru,NRU,1992,10129,0,10129
Nauru,NRU,1993,10226,0,10226
Nauru,NRU,1994,10274,0,10274
Nauru,NRU,1995,10316,0,10316
Nauru,NRU,1996,10345,0,10345
Nauru,NRU,1997,10363,0,10363
Nauru,NRU,1998,10377,0,10377
Nauru,NRU,1999,10383,0,10383
Nauru,NRU,2000,10377,0,10377
Nauru,NRU,2001,10363,0,10363
Nauru,NRU,2002,10351,0,10351
Nauru,NRU,2003,10344,0,10344
Nauru,NRU,2004,10335,0,10335
Nauru,NRU,2005,10318,0,10318
Nauru,NRU,2006,10294,0,10294
Nauru,NRU,2007,10267,0,10267
Nauru,NRU,2008,10243,0,10243
Nauru,NRU,2009,10233,0,10233
Nauru,NRU,2010,10241,0,10241
Nauru,NRU,2011,10283,0,10283
Nauru,NRU,2012,10444,0,10444
Nauru,NRU,2013,10694,0,10694
Nauru,NRU,2014,10940,0,10940
Nauru,NRU,2015,11185,0,11185
Nauru,NRU,2016,11437,0,11437
Nauru,NRU,2017,11682,0,11682
Nauru,NRU,2018,11924,0,11924
Nauru,NRU,2019,12132,0,12132
Nauru,NRU,2020,12315,0,12315
Nauru,NRU,2021,12511,0,12511
Nepal,NPL,1960,353844,9814097,10167941
Nepal,NPL,1961,370139,9995005,10365144
Nepal,NPL,1962,381814,10188902,10570716
Nepal,NPL,1963,393893,10388824,10782717
Nepal,NPL,1964,406554,10596265,11002819
Nepal,NPL,1965,419775,10813176,11232951
Nepal,NPL,1966,433574,11036625,11470199
Nepal,NPL,1967,447887,11267692,11715579
Nepal,NPL,1968,462896,11507515,11970411
Nepal,NPL,1969,478389,11753485,12231874
Nepal,NPL,1970,494551,12006734,12501285
Nepal,NPL,1971,511634,12263236,12774870
Nepal,NPL,1972,547932,12504288,13052220
Nepal,NPL,1973,586649,12749314,13335963
Nepal,NPL,1974,628172,12998129,13626301
Nepal,NPL,1975,672604,13252937,13925541
Nepal,NPL,1976,720218,13510520,14230738
Nepal,NPL,1977,771464,13778966,14550430
Nepal,NPL,1978,826773,14061997,14888770
Nepal,NPL,1979,886275,14352289,15238564
Nepal,NPL,1980,950223,14650219,15600442
Nepal,NPL,1981,1018234,14951558,15969792
Nepal,NPL,1982,1081526,15265598,16347124
Nepal,NPL,1983,1149079,15591585,16740664
Nepal,NPL,1984,1220654,15920956,17141610
Nepal,NPL,1985,1295547,16245024,17540571
Nepal,NPL,1986,1373969,16562957,17936926
Nepal,NPL,1987,1455834,16870370,18326204
Nepal,NPL,1988,1542215,17178530,18720745
Nepal,NPL,1989,1635181,17509896,19145077
Nepal,NPL,1990,1736848,17879682,19616530
Nepal,NPL,1991,1848006,18282772,20130778
Nepal,NPL,1992,1983678,18718456,20702134
Nepal,NPL,1993,2126523,19140836,21267359
Nepal,NPL,1994,2273846,19520904,21794750
Nepal,NPL,1995,2427515,19878056,22305571
Nepal,NPL,1996,2585980,20197988,22783968
Nepal,NPL,1997,2751336,20498080,23249416
Nepal,NPL,1998,2924043,20779284,23703327
Nepal,NPL,1999,3104086,21039072,24143158
Nepal,NPL,2000,3290236,21269264,24559500
Nepal,NPL,2001,3480623,21475448,24956071
Nepal,NPL,2002,3607302,21724876,25332178
Nepal,NPL,2003,3733781,21949128,25682909
Nepal,NPL,2004,3859248,22144716,26003964
Nepal,NPL,2005,3981931,22303180,26285111
Nepal,NPL,2006,4100363,22418608,26518971
Nepal,NPL,2007,4215682,22497972,26713654
Nepal,NPL,2008,4329273,22552272,26881545
Nepal,NPL,2009,4441607,22585334,27026941
Nepal,NPL,2010,4554452,22607116,27161568
Nepal,NPL,2011,4664736,22601664,27266400
Nepal,NPL,2012,4771393,22559300,27330693
Nepal,NPL,2013,4878024,22503532,27381556
Nepal,NPL,2014,4993160,22468946,27462106
Nepal,NPL,2015,5123648,22486676,27610324
Nepal,NPL,2016,5277466,22583720,27861186
Nepal,NPL,2017,5449547,22733880,28183427
Nepal,NPL,2018,5627225,22879488,28506713
Nepal,NPL,2019,5810613,23021884,28832497
Nepal,NPL,2020,6038773,23309854,29348627
Nepal,NPL,2021,6309750,23725240,30034990
Netherlands,NLD,1960,6863492,4623139,11486631
Netherlands,NLD,1961,6985555,4653157,11638712
Netherlands,NLD,1962,7107497,4698192,11805689
Netherlands,NLD,1963,7225888,4740078,11965966
Netherlands,NLD,1964,7345397,4781723,12127120
Netherlands,NLD,1965,7469419,4825313,12294732
Netherlands,NLD,1966,7590341,4865910,12456251
Netherlands,NLD,1967,7699768,4898433,12598201
Netherlands,NLD,1968,7803319,4926402,12729721
Netherlands,NLD,1969,7917513,4960471,12877984
Netherlands,NLD,1970,8039946,4998580,13038526
Netherlands,NLD,1971,8169109,5025388,13194497
Netherlands,NLD,1972,8294650,5033943,13328593
Netherlands,NLD,1973,8406296,5033026,13439322
Netherlands,NLD,1974,8515370,5029686,13545056
Netherlands,NLD,1975,8634800,5031535,13666335
Netherlands,NLD,1976,8746238,5027799,13774037
Netherlands,NLD,1977,8841770,5014415,13856185
Netherlands,NLD,1978,8939836,5001864,13941700
Netherlands,NLD,1979,9045559,4992711,14038270
Netherlands,NLD,1980,9161288,4988512,14149800
Netherlands,NLD,1981,9275502,4971706,14247208
Netherlands,NLD,1982,9376386,4936304,14312690
Netherlands,NLD,1983,9470198,4896872,14367070
Netherlands,NLD,1984,9565992,4858219,14424211
Netherlands,NLD,1985,9668672,4822960,14491632
Netherlands,NLD,1986,9780476,4791802,14572278
Netherlands,NLD,1987,9900806,4764231,14665037
Netherlands,NLD,1988,10022989,4737105,14760094
Netherlands,NLD,1989,10141210,4707697,14848907
Netherlands,NLD,1990,10269295,4682215,14951510
Netherlands,NLD,1991,10447740,4622058,15069798
Netherlands,NLD,1992,10662777,4521389,15184166
Netherlands,NLD,1993,10871452,4418916,15290368
Netherlands,NLD,1994,11069798,4313040,15382838
Netherlands,NLD,1995,11255548,4203458,15459006
Netherlands,NLD,1996,11436659,4093839,15530498
Netherlands,NLD,1997,11622597,3988053,15610650
Netherlands,NLD,1998,11819675,3887534,15707209
Netherlands,NLD,1999,12021931,3790157,15812088
Netherlands,NLD,2000,12229998,3695515,15925513
Netherlands,NLD,2001,12488742,3557438,16046180
Netherlands,NLD,2002,12775902,3373027,16148929
Netherlands,NLD,2003,13035570,3189732,16225302
Netherlands,NLD,2004,13271929,3009850,16281779
Netherlands,NLD,2005,13485107,2834761,16319868
Netherlands,NLD,2006,13671225,2674876,16346101
Netherlands,NLD,2007,13848922,2532774,16381696
Netherlands,NLD,2008,14044865,2400728,16445593
Netherlands,NLD,2009,14263741,2266647,16530388
Netherlands,NLD,2010,14477657,2137737,16615394
Netherlands,NLD,2011,14669707,2023367,16693074
Netherlands,NLD,2012,14842886,1912076,16754962
Netherlands,NLD,2013,14987369,1817063,16804432
Netherlands,NLD,2014,15126226,1738782,16865008
Netherlands,NLD,2015,15275237,1664686,16939923
Netherlands,NLD,2016,15435425,1594889,17030314
Netherlands,NLD,2017,15602670,1528626,17131296
Netherlands,NLD,2018,15765213,1466411,17231624
Netherlands,NLD,2019,15935776,1409098,17344874
Netherlands,NLD,2020,16087342,1354158,17441500
Netherlands,NLD,2021,16230689,1302355,17533044
New Caledonia,NCL,1960,29514,49486,79000
New Caledonia,NCL,1961,31490,49710,81200
New Caledonia,NCL,1962,33547,49853,83400
New Caledonia,NCL,1963,35723,49977,85700
New Caledonia,NCL,1964,38025,50075,88100
New Caledonia,NCL,1965,40405,50095,90500
New Caledonia,NCL,1966,43143,50357,93500
New Caledonia,NCL,1967,45978,50522,96500
New Caledonia,NCL,1968,48910,50590,99500
New Caledonia,NCL,1969,52460,51540,104000
New Caledonia,NCL,1970,57380,54620,112000
New Caledonia,NCL,1971,62426,57574,120000
New Caledonia,NCL,1972,66278,59222,125500
New Caledonia,NCL,1973,68872,59628,128500
New Caledonia,NCL,1974,71240,59760,131000
New Caledonia,NCL,1975,73094,59406,132500
New Caledonia,NCL,1976,74870,59130,134000
New Caledonia,NCL,1977,76516,59484,136000
New Caledonia,NCL,1978,77895,59605,137500
New Caledonia,NCL,1979,78999,59501,138500
New Caledonia,NCL,1980,80425,59625,140050
New Caledonia,NCL,1981,82469,60181,142650
New Caledonia,NCL,1982,84793,60907,145700
New Caledonia,NCL,1983,87037,61663,148700
New Caledonia,NCL,1984,88993,62657,151650
New Caledonia,NCL,1985,90869,63581,154450
New Caledonia,NCL,1986,92813,64537,157350
New Caledonia,NCL,1987,94912,65588,160500
New Caledonia,NCL,1988,97022,66628,163650
New Caledonia,NCL,1989,99194,67704,166898
New Caledonia,NCL,1990,101816,69083,170899
New Caledonia,NCL,1991,104724,70638,175362
New Caledonia,NCL,1992,107631,72168,179799
New Caledonia,NCL,1993,110705,73791,184496
New Caledonia,NCL,1994,113966,75516,189482
New Caledonia,NCL,1995,116848,76968,193816
New Caledonia,NCL,1996,119477,78087,197564
New Caledonia,NCL,1997,122539,78879,201418
New Caledonia,NCL,1998,125629,79650,205279
New Caledonia,NCL,1999,128790,80424,209214
New Caledonia,NCL,2000,132030,81200,213230
New Caledonia,NCL,2001,135341,81983,217324
New Caledonia,NCL,2002,138724,82766,221490
New Caledonia,NCL,2003,141907,83389,225296
New Caledonia,NCL,2004,144893,83857,228750
New Caledonia,NCL,2005,148559,83691,232250
New Caledonia,NCL,2006,152384,83366,235750
New Caledonia,NCL,2007,156245,83005,239250
New Caledonia,NCL,2008,160140,82610,242750
New Caledonia,NCL,2009,163862,82088,245950
New Caledonia,NCL,2010,167587,82163,249750
New Caledonia,NCL,2011,171852,82498,254350
New Caledonia,NCL,2012,176182,82818,259000
New Caledonia,NCL,2013,180545,83105,263650
New Caledonia,NCL,2014,184770,83280,268050
New Caledonia,NCL,2015,186949,82511,269460
New Caledonia,NCL,2016,188670,81550,270220
New Caledonia,NCL,2017,190260,80550,270810
New Caledonia,NCL,2018,191671,79499,271170
New Caledonia,NCL,2019,192855,78375,271230
New Caledonia,NCL,2020,193907,77223.01,271130.01
New Caledonia,NCL,2021,194938,76092.055,271030.055
New Zealand,NZL,1960,1802521,569279,2371800
New Zealand,NZL,1961,1851675,568025,2419700
New Zealand,NZL,1962,1914441,567559,2482000
New Zealand,NZL,1963,1967968,563832,2531800
New Zealand,NZL,1964,2024808,560592,2585400
New Zealand,NZL,1965,2073571,554829,2628400
New Zealand,NZL,1966,2125227,550673,2675900
New Zealand,NZL,1967,2175248,548852,2724100
New Zealand,NZL,1968,2206092,542008,2748100
New Zealand,NZL,1969,2237511,535289,2772800
New Zealand,NZL,1970,2279646,531054,2810700
New Zealand,NZL,1971,2324938,528062,2853000
New Zealand,NZL,1972,2375942,527958,2903900
New Zealand,NZL,1973,2432441,528859,2961300
New Zealand,NZL,1974,2493343,530357,3023700
New Zealand,NZL,1975,2552005,531095,3083100
New Zealand,NZL,1976,2582586,527914,3110500
New Zealand,NZL,1977,2593760,526440,3120200
New Zealand,NZL,1978,2597744,523456,3121200
New Zealand,NZL,1979,2590668,518332,3109000
New Zealand,NZL,1980,2597030,515870,3112900
New Zealand,NZL,1981,2609635,515265,3124900
New Zealand,NZL,1982,2636985,519115,3156100
New Zealand,NZL,1983,2674359,524941,3199300
New Zealand,NZL,1984,2698921,528179,3227100
New Zealand,NZL,1985,2716946,530154,3247100
New Zealand,NZL,1986,2719750,526550,3246300
New Zealand,NZL,1987,2751315,523085,3274400
New Zealand,NZL,1988,2766856,516544,3283400
New Zealand,NZL,1989,2788022,511178,3299200
New Zealand,NZL,1990,2821739,508061,3329800
New Zealand,NZL,1991,2969087,526013,3495100
New Zealand,NZL,1992,3005583,526117,3531700
New Zealand,NZL,1993,3045443,526757,3572200
New Zealand,NZL,1994,3091625,528375,3620000
New Zealand,NZL,1995,3142704,530696,3673400
New Zealand,NZL,1996,3198324,533676,3732000
New Zealand,NZL,1997,3243637,537663,3781300
New Zealand,NZL,1998,3275597,539403,3815000
New Zealand,NZL,1999,3295923,539177,3835100
New Zealand,NZL,2000,3318432,539268,3857700
New Zealand,NZL,2001,3341111,539389,3880500
New Zealand,NZL,2002,3402067,546433,3948500
New Zealand,NZL,2003,3472292,554908,4027200
New Zealand,NZL,2004,3526736,560764,4087500
New Zealand,NZL,2005,3569251,564649,4133900
New Zealand,NZL,2006,3615494,569106,4184600
New Zealand,NZL,2007,3646829,576971,4223800
New Zealand,NZL,2008,3675355,584445,4259800
New Zealand,NZL,2009,3709702,592898,4302600
New Zealand,NZL,2010,3748563,602137,4350700
New Zealand,NZL,2011,3774624,609376,4384000
New Zealand,NZL,2012,3798063,610037,4408100
New Zealand,NZL,2013,3830023,612077,4442100
New Zealand,NZL,2014,3896881,619619,4516500
New Zealand,NZL,2015,3979802,629598,4609400
New Zealand,NZL,2016,4072982,641118,4714100
New Zealand,NZL,2017,4162127,651473,4813600
New Zealand,NZL,2018,4240881,659719,4900600
New Zealand,NZL,2019,4312734,666466,4979200
New Zealand,NZL,2020,4413152,677048,5090200
New Zealand,NZL,2021,4445853,676747,5122600
Nicaragua,NIC,1960,708375,1081309,1789684
Nicaragua,NIC,1961,738405,1106225,1844630
Nicaragua,NIC,1962,769726,1131725,1901451
Nicaragua,NIC,1963,803762,1156393,1960155
Nicaragua,NIC,1964,845865,1175076,2020941
Nicaragua,NIC,1965,890055,1194042,2084097
Nicaragua,NIC,1966,936649,1213354,2150003
Nicaragua,NIC,1967,985836,1233165,2219001
Nicaragua,NIC,1968,1037799,1253501,2291300
Nicaragua,NIC,1969,1092439,1274196,2366635
Nicaragua,NIC,1970,1149774,1294993,2444767
Nicaragua,NIC,1971,1206801,1318680,2525481
Nicaragua,NIC,1972,1251167,1352015,2603182
Nicaragua,NIC,1973,1296867,1385880,2682747
Nicaragua,NIC,1974,1346390,1422821,2769211
Nicaragua,NIC,1975,1397241,1460220,2857461
Nicaragua,NIC,1976,1449469,1497985,2947454
Nicaragua,NIC,1977,1502810,1535870,3038680
Nicaragua,NIC,1978,1555950,1572594,3128544
Nicaragua,NIC,1979,1607573,1606738,3214311
Nicaragua,NIC,1980,1661300,1642009,3303309
Nicaragua,NIC,1981,1718196,1679463,3397659
Nicaragua,NIC,1982,1775599,1716307,3491906
Nicaragua,NIC,1983,1832704,1751906,3584610
Nicaragua,NIC,1984,1888914,1785587,3674501
Nicaragua,NIC,1985,1944886,1818148,3763034
Nicaragua,NIC,1986,2001624,1850393,3852017
Nicaragua,NIC,1987,2059060,1882403,3941463
Nicaragua,NIC,1988,2118244,1915047,4033291
Nicaragua,NIC,1989,2180224,1949223,4129447
Nicaragua,NIC,1990,2243915,1983905,4227820
Nicaragua,NIC,1991,2308695,2018594,4327289
Nicaragua,NIC,1992,2374292,2052880,4427172
Nicaragua,NIC,1993,2440202,2086487,4526689
Nicaragua,NIC,1994,2506105,2119155,4625260
Nicaragua,NIC,1995,2570476,2151453,4721929
Nicaragua,NIC,1996,2626940,2185451,4812391
Nicaragua,NIC,1997,2679903,2216059,4895962
Nicaragua,NIC,1998,2730333,2244219,4974552
Nicaragua,NIC,1999,2779251,2270627,5049878
Nicaragua,NIC,2000,2827250,2295972,5123222
Nicaragua,NIC,2001,2873416,2319348,5192764
Nicaragua,NIC,2002,2917907,2341099,5259006
Nicaragua,NIC,2003,2961379,2361683,5323062
Nicaragua,NIC,2004,3004543,2381680,5386223
Nicaragua,NIC,2005,3051074,2403604,5454678
Nicaragua,NIC,2006,3103994,2425817,5529811
Nicaragua,NIC,2007,3158566,2448887,5607453
Nicaragua,NIC,2008,3214997,2472747,5687744
Nicaragua,NIC,2009,3273164,2497475,5770639
Nicaragua,NIC,2010,3332908,2522826,5855734
Nicaragua,NIC,2011,3393970,2548583,5942553
Nicaragua,NIC,2012,3456081,2574526,6030607
Nicaragua,NIC,2013,3518949,2600430,6119379
Nicaragua,NIC,2014,3582406,2626270,6208676
Nicaragua,NIC,2015,3646573,2652025,6298598
Nicaragua,NIC,2016,3711507,2677728,6389235
Nicaragua,NIC,2017,3778085,2702447,6480532
Nicaragua,NIC,2018,3846202,2726031,6572233
Nicaragua,NIC,2019,3915722,2748202,6663924
Nicaragua,NIC,2020,3986789,2769106,6755895
Nicaragua,NIC,2021,4060795,2789745,6850540
Niger,NER,1960,202606,3294825,3497431
Niger,NER,1961,212405,3390125,3602530
Niger,NER,1962,222664,3488404,3711068
Niger,NER,1963,239263,3583434,3822697
Niger,NER,1964,257047,3679961,3937008
Niger,NER,1965,276004,3777520,4053524
Niger,NER,1966,296248,3876253,4172501
Niger,NER,1967,321771,3972512,4294283
Niger,NER,1968,349283,4068671,4417954
Niger,NER,1969,378840,4164153,4542993
Niger,NER,1970,410654,4259054,4669708
Niger,NER,1971,444736,4352332,4797068
Niger,NER,1972,481400,4444918,4926318
Niger,NER,1973,520914,4538468,5059382
Niger,NER,1974,563569,4633010,5196579
Niger,NER,1975,609717,4729780,5339497
Niger,NER,1976,659792,4828866,5488658
Niger,NER,1977,713942,4930761,5644703
Niger,NER,1978,756798,5053553,5810351
Niger,NER,1979,792280,5194871,5987151
Niger,NER,1980,829860,5343317,6173177
Niger,NER,1981,869377,5496885,6366262
Niger,NER,1982,910554,5653891,6564445
Niger,NER,1983,953415,5813191,6766606
Niger,NER,1984,998097,5975752,6973849
Niger,NER,1985,1044792,6142826,7187618
Niger,NER,1986,1093697,6314667,7408364
Niger,NER,1987,1144954,6491637,7636591
Niger,NER,1988,1197291,6674961,7872252
Niger,NER,1989,1240867,6875208,8116075
Niger,NER,1990,1286401,7084247,8370648
Niger,NER,1991,1333966,7300674,8634640
Niger,NER,1992,1383268,7524376,8907644
Niger,NER,1993,1435039,7758039,9193078
Niger,NER,1994,1489597,8003727,9493324
Niger,NER,1995,1547949,8265969,9813918
Niger,NER,1996,1609273,8540664,10149937
Niger,NER,1997,1672461,8821740,10494201
Niger,NER,1998,1738958,9115962,10854920
Niger,NER,1999,1808603,9422866,11231469
Niger,NER,2000,1881245,9741420,11622665
Niger,NER,2001,1956311,10075119,12031430
Niger,NER,2002,2024807,10431710,12456517
Niger,NER,2003,2096507,10804283,12900790
Niger,NER,2004,2171718,11195167,13366885
Niger,NER,2005,2250365,11604856,13855221
Niger,NER,2006,2332616,12032552,14365168
Niger,NER,2007,2418521,12479352,14897873
Niger,NER,2008,2508220,12946955,15455175
Niger,NER,2009,2602152,13435763,16037915
Niger,NER,2010,2700398,13947145,16647543
Niger,NER,2011,2802629,14480483,17283112
Niger,NER,2012,2910768,15043639,17954407
Niger,NER,2013,3023310,15629889,18653199
Niger,NER,2014,3141947,16230067,19372014
Niger,NER,2015,3270216,16857908,20128124
Niger,NER,2016,3408152,17513592,20921744
Niger,NER,2017,3554150,18183772,21737922
Niger,NER,2018,3708282,18868776,22577058
Niger,NER,2019,3872145,19571248,23443393
Niger,NER,2020,4045711,20287928,24333639
Niger,NER,2021,4230083,21022640,25252723
Nigeria,NGA,1960,6923458,38004884,44928342
Nigeria,NGA,1961,7168591,38686916,45855507
Nigeria,NGA,1962,7425008,39396836,46821844
Nigeria,NGA,1963,7693217,40129350,47822567
Nigeria,NGA,1964,7972376,40883956,48856332
Nigeria,NGA,1965,8263219,41662580,49925799
Nigeria,NGA,1966,8565287,42455010,51020297
Nigeria,NGA,1967,8872205,43234476,52106681
Nigeria,NGA,1968,9188855,44021264,53210119
Nigeria,NGA,1969,9520198,44840550,54360748
Nigeria,NGA,1970,9869101,45700164,55569265
Nigeria,NGA,1971,10316595,46521020,56837615
Nigeria,NGA,1972,10790664,47383170,58173834
Nigeria,NGA,1973,11296424,48309024,59605448
Nigeria,NGA,1974,11842010,49315920,61157930
Nigeria,NGA,1975,12431990,50419320,62851310
Nigeria,NGA,1976,13064213,51594104,64658317
Nigeria,NGA,1977,13741441,52848216,66589657
Nigeria,NGA,1978,14463791,54169550,68633341
Nigeria,NGA,1979,15224051,55526256,70750307
Nigeria,NGA,1980,16027431,56924010,72951441
Nigeria,NGA,1981,17043012,58132376,75175388
Nigeria,NGA,1982,18100295,59287772,77388067
Nigeria,NGA,1983,19141190,60210396,79351586
Nigeria,NGA,1984,20230276,61107276,81337552
Nigeria,NGA,1985,21427079,62158172,83585251
Nigeria,NGA,1986,22664317,63139868,85804185
Nigeria,NGA,1987,23955943,64088244,88044187
Nigeria,NGA,1988,25315578,65035890,90351468
Nigeria,NGA,1989,26749243,65994820,92744063
Nigeria,NGA,1990,28259591,66954664,95214255
Nigeria,NGA,1991,29477534,68207820,97685354
Nigeria,NGA,1992,30732846,69449200,100182046
Nigeria,NGA,1993,32047445,70728020,102775465
Nigeria,NGA,1994,33420099,72036024,105456123
Nigeria,NGA,1995,34841820,73345790,108187610
Nigeria,NGA,1996,36310411,74645780,110956191
Nigeria,NGA,1997,37832154,75959020,113791174
Nigeria,NGA,1998,39409892,77280630,116690522
Nigeria,NGA,1999,41060367,78635200,119695567
Nigeria,NGA,2000,42801631,80050350,122851981
Nigeria,NGA,2001,44997399,81155280,126152679
Nigeria,NGA,2002,47308171,82274856,129583027
Nigeria,NGA,2003,49728233,83391570,133119803
Nigeria,NGA,2004,52257527,84499320,136756847
Nigeria,NGA,2005,54895345,85595380,140490725
Nigeria,NGA,2006,57649638,86680130,144329768
Nigeria,NGA,2007,60532139,87761890,148294029
Nigeria,NGA,2008,63546553,88835950,152382503
Nigeria,NGA,2009,66691001,89904760,156595761
Nigeria,NGA,2010,69982300,90970550,160952850
Nigeria,NGA,2011,73409645,92054100,165463745
Nigeria,NGA,2012,76952556,93123380,170075936
Nigeria,NGA,2013,80580193,94145930,174726123
Nigeria,NGA,2014,84275849,95103170,179379019
Nigeria,NGA,2015,88019904,95975880,183995784
Nigeria,NGA,2016,91848722,96818210,188666932
Nigeria,NGA,2017,95817238,97678670,193495908
Nigeria,NGA,2018,99876265,98511360,198387625
Nigeria,NGA,2019,104004479,99300020,203304499
Nigeria,NGA,2020,108242753,100084660,208327413
Nigeria,NGA,2021,112560662,100840664,213401326
North America (WB),,1960,138875253,59749504,198624757
North America (WB),,1961,142050755,59956744,202007499
North America (WB),,1962,145157046,60041550,205198596
North America (WB),,1963,148185763,60067936,208253699
North America (WB),,1964,151199564,60063336,211262900
North America (WB),,1965,154056841,59974260,214031101
North America (WB),,1966,156823451,59835548,216658999
North America (WB),,1967,159477276,59698724,219176000
North America (WB),,1968,162004081,59498920,221503001
North America (WB),,1969,164487979,59271020,223758999
North America (WB),,1970,167109832,59321170,226431002
North America (WB),,1971,169631002,60046630,229677632
North America (WB),,1972,171465521,60703144,232168665
North America (WB),,1973,173148992,61305584,234454576
North America (WB),,1974,174814604,61900764,236715368
North America (WB),,1975,176622456,62546820,239169276
North America (WB),,1976,178369631,63168376,241538007
North America (WB),,1977,180233292,63784950,244018242
North America (WB),,1978,182170788,64431016,246601804
North America (WB),,1979,184203265,65107080,249310345
North America (WB),,1980,186155130,65640210,251795340
North America (WB),,1981,188399131,65941830,254340961
North America (WB),,1982,190641337,66195056,256836393
North America (WB),,1983,192802947,66411430,259214377
North America (WB),,1984,194889455,66599020,261488475
North America (WB),,1985,197027492,66795520,263823012
North America (WB),,1986,199269494,67021170,266290664
North America (WB),,1987,201510529,67282920,268793449
North America (WB),,1988,203797727,67551370,271349097
North America (WB),,1989,206276409,67878216,274154625
North America (WB),,1990,209231872,68141590,277373462
North America (WB),,1991,213050439,68027000,281077439
North America (WB),,1992,217071868,67871990,284943858
North America (WB),,1993,220996624,67666050,288662674
North America (WB),,1994,224788006,67397976,292185982
North America (WB),,1995,228538710,67101348,295640058
North America (WB),,1996,232288316,66776030,299064346
North America (WB),,1997,236183090,66440356,302623446
North America (WB),,1998,240006391,66063724,306070115
North America (WB),,1999,243831291,65671280,309502571
North America (WB),,2000,247519374,65390600,312909974
North America (WB),,2001,250612588,65439772,316052360
North America (WB),,2002,253516142,65532040,319048182
North America (WB),,2003,256244701,65570584,321815285
North America (WB),,2004,259163359,65646336,324809695
North America (WB),,2005,262099001,65725504,327824505
North America (WB),,2006,265190165,65825444,331015609
North America (WB),,2007,268301627,65883492,334185119
North America (WB),,2008,271462240,65944116,337406356
North America (WB),,2009,274499918,65966144,340466062
North America (WB),,2010,277437381,65959776,343397157
North America (WB),,2011,280120518,65866856,345987374
North America (WB),,2012,282845297,65811384,348656681
North America (WB),,2013,285498217,65709684,351207901
North America (WB),,2014,288277446,65611456,353888902
North America (WB),,2015,291027807,65479332,356507139
North America (WB),,2016,293894567,65351228,359245795
North America (WB),,2017,296582138,65149100,361731238
North America (WB),,2018,299083003,64884200,363967203
North America (WB),,2019,301439741,64555350,365995091
North America (WB),,2020,305119850,64482330,369602180
North America (WB),,2021,306343265,63860456,370203721
North Korea,PRK,1960,4684995,6970671,11655666
North Korea,PRK,1961,4905076,7011439,11916515
North Korea,PRK,1962,5132378,7048127,12180505
North Korea,PRK,1963,5378823,7096413,12475236
North Korea,PRK,1964,5639553,7147970,12787523
North Korea,PRK,1965,5909602,7196344,13105946
North Korea,PRK,1966,6195555,7248493,13444048
North Korea,PRK,1967,6507258,7314151,13821409
North Korea,PRK,1968,6967695,7248610,14216305
North Korea,PRK,1969,7537743,7067738,14605481
North Korea,PRK,1970,8128308,6868571,14996879
North Korea,PRK,1971,8414057,6967569,15381626
North Korea,PRK,1972,8704767,7063596,15768363
North Korea,PRK,1973,8983848,7144274,16128122
North Korea,PRK,1974,9237924,7199078,16437002
North Korea,PRK,1975,9482084,7241168,16723252
North Korea,PRK,1976,9638520,7348650,16987170
North Korea,PRK,1977,9783983,7447406,17231389
North Korea,PRK,1978,9927644,7544450,17472094
North Korea,PRK,1979,10075121,7644051,17719172
North Korea,PRK,1980,10227007,7746643,17973650
North Korea,PRK,1981,10403000,7832202,18235202
North Korea,PRK,1982,10582824,7919263,18502087
North Korea,PRK,1983,10764626,8006737,18771363
North Korea,PRK,1984,10950011,8095143,19045154
North Korea,PRK,1985,11139984,8185503,19325487
North Korea,PRK,1986,11334767,8278271,19613038
North Korea,PRK,1987,11532316,8371577,19903893
North Korea,PRK,1988,11732303,8465161,20197464
North Korea,PRK,1989,11935448,8559517,20494965
North Korea,PRK,1990,12143594,8655929,20799523
North Korea,PRK,1991,12359133,8756401,21115534
North Korea,PRK,1992,12580772,8859219,21439991
North Korea,PRK,1993,12808195,8964822,21773017
North Korea,PRK,1994,13028599,9076626,22105225
North Korea,PRK,1995,13211496,9174040,22385536
North Korea,PRK,1996,13364401,9249946,22614347
North Korea,PRK,1997,13508326,9319047,22827373
North Korea,PRK,1998,13642656,9380980,23023636
North Korea,PRK,1999,13768157,9436341,23204498
North Korea,PRK,2000,13882837,9484222,23367059
North Korea,PRK,2001,13987834,9524688,23512522
North Korea,PRK,2002,14081401,9557010,23638411
North Korea,PRK,2003,14185313,9596394,23781707
North Korea,PRK,2004,14303977,9644953,23948930
North Korea,PRK,2005,14413592,9687390,24100982
North Korea,PRK,2006,14513343,9722418,24235761
North Korea,PRK,2007,14604648,9751858,24356506
North Korea,PRK,2008,14691216,9777831,24469047
North Korea,PRK,2009,14796839,9784670,24581509
North Korea,PRK,2010,14904929,9781506,24686435
North Korea,PRK,2011,15008319,9775470,24783789
North Korea,PRK,2012,15116334,9771436,24887770
North Korea,PRK,2013,15230608,9771211,25001819
North Korea,PRK,2014,15351564,9774567,25126131
North Korea,PRK,2015,15477354,9780661,25258015
North Korea,PRK,2016,15607248,9782363,25389611
North Korea,PRK,2017,15737956,9778365,25516321
North Korea,PRK,2018,15869758,9768391,25638149
North Korea,PRK,2019,16002886,9752555,25755441
North Korea,PRK,2020,16136385,9731082,25867467
North Korea,PRK,2021,16269323,9702586,25971909
North Macedonia,MKD,1960,497498,964870,1462368
North Macedonia,MKD,1961,521559,959553,1481112
North Macedonia,MKD,1962,546124,951214,1497338
North Macedonia,MKD,1963,570725,941129,1511854
North Macedonia,MKD,1964,597227,932280,1529507
North Macedonia,MKD,1965,624688,923294,1547982
North Macedonia,MKD,1966,653420,914287,1567707
North Macedonia,MKD,1967,683373,905276,1588649
North Macedonia,MKD,1968,714499,896038,1610537
North Macedonia,MKD,1969,746804,886698,1633502
North Macedonia,MKD,1970,779997,876786,1656783
North Macedonia,MKD,1971,810056,868956,1679012
North Macedonia,MKD,1972,830790,870708,1701498
North Macedonia,MKD,1973,852383,872845,1725228
North Macedonia,MKD,1974,874455,874874,1749329
North Macedonia,MKD,1975,897101,876912,1774013
North Macedonia,MKD,1976,920376,878956,1799332
North Macedonia,MKD,1977,944227,881072,1825299
North Macedonia,MKD,1978,968770,883208,1851978
North Macedonia,MKD,1979,993972,885382,1879354
North Macedonia,MKD,1980,1019666,887357,1907023
North Macedonia,MKD,1981,1045143,890057,1935200
North Macedonia,MKD,1982,1065889,892386,1958275
North Macedonia,MKD,1983,1083040,891401,1974441
North Macedonia,MKD,1984,1099264,889418,1988682
North Macedonia,MKD,1985,1114758,886746,2001504
North Macedonia,MKD,1986,1129594,883332,2012926
North Macedonia,MKD,1987,1143778,879319,2023097
North Macedonia,MKD,1988,1157287,874645,2031932
North Macedonia,MKD,1989,1170080,869346,2039426
North Macedonia,MKD,1990,1181308,862866,2044174
North Macedonia,MKD,1991,1186044,850642,2036686
North Macedonia,MKD,1992,1185871,832152,2018023
North Macedonia,MKD,1993,1183978,812915,1996893
North Macedonia,MKD,1994,1185391,797067,1982458
North Macedonia,MKD,1995,1182185,801779,1983964
North Macedonia,MKD,1996,1184171,810055,1994226
North Macedonia,MKD,1997,1181587,815282,1996869
North Macedonia,MKD,1998,1183736,823787,2007523
North Macedonia,MKD,1999,1185212,831930,2017142
North Macedonia,MKD,2000,1186387,839963,2026350
North Macedonia,MKD,2001,1187130,847752,2034882
North Macedonia,MKD,2002,1174317,845840,2020157
North Macedonia,MKD,2003,1173927,852846,2026773
North Macedonia,MKD,2004,1173001,859543,2032544
North Macedonia,MKD,2005,1171843,865012,2036855
North Macedonia,MKD,2006,1170744,869484,2040228
North Macedonia,MKD,2007,1170224,873335,2043559
North Macedonia,MKD,2008,1170314,876584,2046898
North Macedonia,MKD,2009,1171282,879389,2050671
North Macedonia,MKD,2010,1173181,881823,2055004
North Macedonia,MKD,2011,1175261,883278,2058539
North Macedonia,MKD,2012,1177371,883673,2061044
North Macedonia,MKD,2013,1180399,883633,2064032
North Macedonia,MKD,2014,1184330,883141,2067471
North Macedonia,MKD,2015,1188475,881751,2070226
North Macedonia,MKD,2016,1192987,879503,2072490
North Macedonia,MKD,2017,1197983,876519,2074502
North Macedonia,MKD,2018,1203438,872779,2076217
North Macedonia,MKD,2019,1208802,867892,2076694
North Macedonia,MKD,2020,1212058,860473,2072531
North Macedonia,MKD,2021,1213985,851107,2065092
Northern Mariana Islands,MNP,1960,4457,4245,8702
Northern Mariana Islands,MNP,1961,4728,4237,8965
Northern Mariana Islands,MNP,1962,5020,4232,9252
Northern Mariana Islands,MNP,1963,5332,4229,9561
Northern Mariana Islands,MNP,1964,5664,4226,9890
Northern Mariana Islands,MNP,1965,6010,4219,10229
Northern Mariana Islands,MNP,1966,6371,4206,10577
Northern Mariana Islands,MNP,1967,6613,4107,10720
Northern Mariana Islands,MNP,1968,6743,3697,10440
Northern Mariana Islands,MNP,1969,6706,3246,9952
Northern Mariana Islands,MNP,1970,7106,3037,10143
Northern Mariana Islands,MNP,1971,8190,3089,11279
Northern Mariana Islands,MNP,1972,9550,3180,12730
Northern Mariana Islands,MNP,1973,10892,3202,14094
Northern Mariana Islands,MNP,1974,11777,3128,14905
Northern Mariana Islands,MNP,1975,12300,2969,15269
Northern Mariana Islands,MNP,1976,12789,2806,15595
Northern Mariana Islands,MNP,1977,13257,2644,15901
Northern Mariana Islands,MNP,1978,13708,2486,16194
Northern Mariana Islands,MNP,1979,14160,2334,16494
Northern Mariana Islands,MNP,1980,15285,2328,17613
Northern Mariana Islands,MNP,1981,17338,2564,19902
Northern Mariana Islands,MNP,1982,19803,2844,22647
Northern Mariana Islands,MNP,1983,22462,3132,25594
Northern Mariana Islands,MNP,1984,25309,3426,28735
Northern Mariana Islands,MNP,1985,28318,3723,32041
Northern Mariana Islands,MNP,1986,31445,4014,35459
Northern Mariana Islands,MNP,1987,34630,4293,38923
Northern Mariana Islands,MNP,1988,37828,4553,42381
Northern Mariana Islands,MNP,1989,41060,4799,45859
Northern Mariana Islands,MNP,1990,43073,4929,48002
Northern Mariana Islands,MNP,1991,43325,4977,48302
Northern Mariana Islands,MNP,1992,43153,4975,48128
Northern Mariana Islands,MNP,1993,42974,4974,47948
Northern Mariana Islands,MNP,1994,42807,4973,47780
Northern Mariana Islands,MNP,1995,43629,5088,48717
Northern Mariana Islands,MNP,1996,47846,5521,53367
Northern Mariana Islands,MNP,1997,54604,6213,60817
Northern Mariana Islands,MNP,1998,61591,6910,68501
Northern Mariana Islands,MNP,1999,68642,7595,76237
Northern Mariana Islands,MNP,2000,72426,7912,80338
Northern Mariana Islands,MNP,2001,71718,7761,79479
Northern Mariana Islands,MNP,2002,69690,7472,77162
Northern Mariana Islands,MNP,2003,67458,7165,74623
Northern Mariana Islands,MNP,2004,65052,6846,71898
Northern Mariana Islands,MNP,2005,62508,6517,69025
Northern Mariana Islands,MNP,2006,59875,6185,66060
Northern Mariana Islands,MNP,2007,57196,5854,63050
Northern Mariana Islands,MNP,2008,54506,5526,60032
Northern Mariana Islands,MNP,2009,51848,5208,57056
Northern Mariana Islands,MNP,2010,49192,4895,54087
Northern Mariana Islands,MNP,2011,47808,4712,52520
Northern Mariana Islands,MNP,2012,47703,4656,52359
Northern Mariana Islands,MNP,2013,47547,4594,52141
Northern Mariana Islands,MNP,2014,47331,4525,51856
Northern Mariana Islands,MNP,2015,47062,4452,51514
Northern Mariana Islands,MNP,2016,46758,4375,51133
Northern Mariana Islands,MNP,2017,46432,4297,50729
Northern Mariana Islands,MNP,2018,46088,4216,50304
Northern Mariana Islands,MNP,2019,45724,4134,49858
Northern Mariana Islands,MNP,2020,45520,4067,49587
Northern Mariana Islands,MNP,2021,45468,4013,49481
Norway,NOR,1960,1787755,1793484,3581239
Norway,NOR,1961,1840926,1768874,3609800
Norway,NOR,1962,1915999,1722919,3638918
Norway,NOR,1963,1991003,1675534,3666537
Norway,NOR,1964,2066761,1627578,3694339
Norway,NOR,1965,2143353,1579815,3723168
Norway,NOR,1966,2220995,1532017,3753012
Norway,NOR,1967,2299864,1484675,3784539
Norway,NOR,1968,2379197,1437289,3816486
Norway,NOR,1969,2457954,1389753,3847707
Norway,NOR,1970,2534594,1341169,3875763
Norway,NOR,1971,2584983,1318056,3903039
Norway,NOR,1972,2624297,1308707,3933004
Norway,NOR,1973,2662165,1298447,3960612
Norway,NOR,1974,2698139,1287119,3985258
Norway,NOR,1975,2732467,1274846,4007313
Norway,NOR,1976,2764638,1261514,4026152
Norway,NOR,1977,2795553,1247652,4043205
Norway,NOR,1978,2825403,1233268,4058671
Norway,NOR,1979,2854061,1218456,4072517
Norway,NOR,1980,2882201,1203419,4085620
Norway,NOR,1981,2902056,1197646,4099702
Norway,NOR,1982,2918125,1196662,4114787
Norway,NOR,1983,2933210,1195222,4128432
Norway,NOR,1984,2946922,1193177,4140099
Norway,NOR,1985,2961159,1191357,4152516
Norway,NOR,1986,2977158,1190196,4167354
Norway,NOR,1987,2996568,1190337,4186905
Norway,NOR,1988,3018161,1191327,4209488
Norway,NOR,1989,3036098,1190803,4226901
Norway,NOR,1990,3051994,1189479,4241473
Norway,NOR,1991,3079741,1181991,4261732
Norway,NOR,1992,3114713,1171688,4286401
Norway,NOR,1993,3150384,1161607,4311991
Norway,NOR,1994,3185372,1151241,4336613
Norway,NOR,1995,3216511,1142673,4359184
Norway,NOR,1996,3244905,1136431,4381336
Norway,NOR,1997,3280785,1124372,4405157
Norway,NOR,1998,3324794,1106670,4431464
Norway,NOR,1999,3371823,1090090,4461913
Norway,NOR,2000,3414033,1076934,4490967
Norway,NOR,2001,3447513,1066238,4513751
Norway,NOR,2002,3482266,1055893,4538159
Norway,NOR,2003,3518773,1046082,4564855
Norway,NOR,2004,3554092,1037818,4591910
Norway,NOR,2005,3591141,1032150,4623291
Norway,NOR,2006,3632998,1027679,4660677
Norway,NOR,2007,3684159,1024994,4709153
Norway,NOR,2008,3744286,1023926,4768212
Norway,NOR,2009,3805760,1022966,4828726
Norway,NOR,2010,3867496,1021756,4889252
Norway,NOR,2011,3935476,1017612,4953088
Norway,NOR,2012,4008535,1010038,5018573
Norway,NOR,2013,4078226,1001397,5079623
Norway,NOR,2014,4145335,991897,5137232
Norway,NOR,2015,4207493,981114,5188607
Norway,NOR,2016,4265348,969171,5234519
Norway,NOR,2017,4320306,956662,5276968
Norway,NOR,2018,4368945,942971,5311916
Norway,NOR,2019,4418218,929678,5347896
Norway,NOR,2020,4463566,915909,5379475
Norway,NOR,2021,4506374,901946,5408320
Oman,OMN,1960,87995,448558,536553
Oman,OMN,1961,95491,450952,546443
Oman,OMN,1962,103667,453472,557139
Oman,OMN,1963,112549,456054,568603
Oman,OMN,1964,122205,458619,580824
Oman,OMN,1965,132645,461163,593808
Oman,OMN,1966,143950,463588,607538
Oman,OMN,1967,156170,465872,622042
Oman,OMN,1968,169383,467996,637379
Oman,OMN,1969,183614,469979,653593
Oman,OMN,1970,198961,471732,670693
Oman,OMN,1971,215506,473297,688803
Oman,OMN,1972,233357,474688,708045
Oman,OMN,1973,252597,476000,728597
Oman,OMN,1974,274876,479800,754676
Oman,OMN,1975,300810,486384,787194
Oman,OMN,1976,329954,494127,824081
Oman,OMN,1977,362802,503322,866124
Oman,OMN,1978,399438,513312,912750
Oman,OMN,1979,439808,523543,963351
Oman,OMN,1980,483925,533537,1017462
Oman,OMN,1981,532122,543502,1075624
Oman,OMN,1982,584916,553385,1138301
Oman,OMN,1983,641993,562633,1204626
Oman,OMN,1984,702827,570479,1273306
Oman,OMN,1985,772444,580845,1353289
Oman,OMN,1986,850825,592621,1443446
Oman,OMN,1987,932017,601334,1533351
Oman,OMN,1988,1016172,607261,1623433
Oman,OMN,1989,1103129,610709,1713838
Oman,OMN,1990,1192826,611698,1804524
Oman,OMN,1991,1284861,610326,1895187
Oman,OMN,1992,1378681,606546,1985227
Oman,OMN,1993,1471938,599930,2071868
Oman,OMN,1994,1529589,604086,2133675
Oman,OMN,1995,1557132,615540,2172672
Oman,OMN,1996,1583413,626545,2209958
Oman,OMN,1997,1608492,637096,2245588
Oman,OMN,1998,1632490,647237,2279727
Oman,OMN,1999,1655567,657033,2312600
Oman,OMN,2000,1677758,666495,2344253
Oman,OMN,2001,1699040,675613,2374653
Oman,OMN,2002,1719313,684346,2403659
Oman,OMN,2003,1738813,692787,2431600
Oman,OMN,2004,1773304,695551,2468855
Oman,OMN,2005,1820999,694193,2515192
Oman,OMN,2006,1868429,692220,2560649
Oman,OMN,2007,1915893,689807,2605700
Oman,OMN,2008,1963882,687146,2651028
Oman,OMN,2009,2013010,684527,2697537
Oman,OMN,2010,2166075,715839,2881914
Oman,OMN,2011,2443090,763780,3206870
Oman,OMN,2012,2742336,793243,3535579
Oman,OMN,2013,3010674,806006,3816680
Oman,OMN,2014,3213227,796040,4009267
Oman,OMN,2015,3410010,781766,4191776
Oman,OMN,2016,3628408,769662,4398070
Oman,OMN,2017,3795173,746681,4541854
Oman,OMN,2018,3889772,711385,4601157
Oman,OMN,2019,3932743,670025,4602768
Oman,OMN,2020,3919863,623536,4543399
Oman,OMN,2021,3934799,585672,4520471
Pakistan,PAK,1960,10157722,35796504,45954226
Pakistan,PAK,1961,10589176,36471740,47060916
Pakistan,PAK,1962,10957300,37204540,48161840
Pakistan,PAK,1963,11345748,37979304,49325052
Pakistan,PAK,1964,11756511,38796080,50552591
Pakistan,PAK,1965,12188485,39653140,51841625
Pakistan,PAK,1966,12644969,40554444,53199413
Pakistan,PAK,1967,13126447,41503344,54629791
Pakistan,PAK,1968,13632139,42492604,56124743
Pakistan,PAK,1969,14160809,43515996,57676805
Pakistan,PAK,1970,14714216,44576656,59290872
Pakistan,PAK,1971,15270833,45607948,60878781
Pakistan,PAK,1972,15848050,46661516,62509566
Pakistan,PAK,1973,16502763,47782860,64285623
Pakistan,PAK,1974,17202091,48947080,66149171
Pakistan,PAK,1975,17945333,50181664,68126997
Pakistan,PAK,1976,18738313,51492610,70230923
Pakistan,PAK,1977,19578462,52872644,72451106
Pakistan,PAK,1978,20468344,54320984,74789328
Pakistan,PAK,1979,21453445,55953896,77407341
Pakistan,PAK,1980,22627948,57996108,80624056
Pakistan,PAK,1981,23915883,60354320,84270203
Pakistan,PAK,1982,25135552,62692650,87828202
Pakistan,PAK,1983,26284885,64795490,91080375
Pakistan,PAK,1984,27356065,66647800,94003865
Pakistan,PAK,1985,28499348,68622210,97121558
Pakistan,PAK,1986,29771009,70847510,100618519
Pakistan,PAK,1987,31101229,73149864,104251093
Pakistan,PAK,1988,32476726,75491110,107967836
Pakistan,PAK,1989,33866278,77804110,111670388
Pakistan,PAK,1990,35289006,80125064,115414070
Pakistan,PAK,1991,36745692,82457880,119203572
Pakistan,PAK,1992,38030534,84344650,122375184
Pakistan,PAK,1993,39332499,86214110,125546609
Pakistan,PAK,1994,40818200,88426936,129245136
Pakistan,PAK,1995,42379280,90738190,133117470
Pakistan,PAK,1996,44041395,93193416,137234811
Pakistan,PAK,1997,45717515,95612750,141330265
Pakistan,PAK,1998,47403389,98072720,145476109
Pakistan,PAK,1999,49074335,100620130,149694465
Pakistan,PAK,2000,50914288,103455630,154369918
Pakistan,PAK,2001,52828442,106389290,159217732
Pakistan,PAK,2002,54497125,108765680,163262805
Pakistan,PAK,2003,56037189,110839490,166876679
Pakistan,PAK,2004,57646810,113001810,170648620
Pakistan,PAK,2005,59255126,115116980,174372106
Pakistan,PAK,2006,60871443,117198540,178069983
Pakistan,PAK,2007,62558385,119366136,181924521
Pakistan,PAK,2008,64313863,121618100,185931963
Pakistan,PAK,2009,66149573,123973650,190123223
Pakistan,PAK,2010,68053241,126401256,194454497
Pakistan,PAK,2011,69912136,128690600,198602736
Pakistan,PAK,2012,71597051,130608810,202205861
Pakistan,PAK,2013,73126866,132210696,205337562
Pakistan,PAK,2014,74593651,133657976,208251627
Pakistan,PAK,2015,76003799,134965500,210969299
Pakistan,PAK,2016,77368591,136156260,213524851
Pakistan,PAK,2017,78853074,137526580,216379654
Pakistan,PAK,2018,80566744,139164740,219731484
Pakistan,PAK,2019,82410851,140882430,223293281
Pakistan,PAK,2020,84437669,142759070,227196739
Pakistan,PAK,2021,86636953,144765170,231402123
Palau,PLW,1960,5368,4078,9446
Palau,PLW,1961,5505,4134,9639
Palau,PLW,1962,5655,4196,9851
Palau,PLW,1963,5813,4263,10076
Palau,PLW,1964,5983,4335,10318
Palau,PLW,1965,6156,4407,10563
Palau,PLW,1966,6333,4480,10813
Palau,PLW,1967,6469,4523,10992
Palau,PLW,1968,6552,4527,11079
Palau,PLW,1969,6632,4527,11159
Palau,PLW,1970,6787,4579,11366
Palau,PLW,1971,7044,4696,11740
Palau,PLW,1972,7338,4834,12172
Palau,PLW,1973,7596,4945,12541
Palau,PLW,1974,7705,4957,12662
Palau,PLW,1975,7708,4899,12607
Palau,PLW,1976,7702,4837,12539
Palau,PLW,1977,7690,4773,12463
Palau,PLW,1978,7678,4709,12387
Palau,PLW,1979,7658,4642,12300
Palau,PLW,1980,7663,4589,12252
Palau,PLW,1981,7854,4532,12386
Palau,PLW,1982,8160,4506,12666
Palau,PLW,1983,8487,4486,12973
Palau,PLW,1984,8832,4467,13299
Palau,PLW,1985,9193,4451,13644
Palau,PLW,1986,9536,4449,13985
Palau,PLW,1987,9808,4501,14309
Palau,PLW,1988,10080,4552,14632
Palau,PLW,1989,10356,4601,14957
Palau,PLW,1990,10643,4650,15293
Palau,PLW,1991,10943,4697,15640
Palau,PLW,1992,11257,4747,16004
Palau,PLW,1993,11581,4799,16380
Palau,PLW,1994,11918,4852,16770
Palau,PLW,1995,12293,4916,17209
Palau,PLW,1996,12644,5088,17732
Palau,PLW,1997,13003,5294,18297
Palau,PLW,1998,13352,5500,18852
Palau,PLW,1999,13679,5701,19380
Palau,PLW,2000,13875,5851,19726
Palau,PLW,2001,13898,5930,19828
Palau,PLW,2002,13865,5986,19851
Palau,PLW,2003,13836,6044,19880
Palau,PLW,2004,14011,5896,19907
Palau,PLW,2005,14110,5721,19831
Palau,PLW,2006,14108,5511,19619
Palau,PLW,2007,14070,5296,19366
Palau,PLW,2008,14019,5083,19102
Palau,PLW,2009,13952,4874,18826
Palau,PLW,2010,13871,4669,18540
Palau,PLW,2011,13773,4467,18240
Palau,PLW,2012,13674,4272,17946
Palau,PLW,2013,13685,4120,17805
Palau,PLW,2014,13795,4001,17796
Palau,PLW,2015,13908,3886,17794
Palau,PLW,2016,14035,3781,17816
Palau,PLW,2017,14156,3681,17837
Palau,PLW,2018,14279,3585,17864
Palau,PLW,2019,14417,3499,17916
Palau,PLW,2020,14555,3417,17972
Palau,PLW,2021,14686,3338,18024
Palestine,PSE,1990,1339452,638796,1978248
Palestine,PSE,1991,1411345,657500,2068845
Palestine,PSE,1992,1486950,676641,2163591
Palestine,PSE,1993,1566383,696293,2262676
Palestine,PSE,1994,1649878,716420,2366298
Palestine,PSE,1995,1737611,737055,2474666
Palestine,PSE,1996,1829843,758154,2587997
Palestine,PSE,1997,1926689,779829,2706518
Palestine,PSE,1998,1985912,790656,2776568
Palestine,PSE,1999,2043664,804767,2848431
Palestine,PSE,2000,2103044,819109,2922153
Palestine,PSE,2001,2164070,833714,2997784
Palestine,PSE,2002,2226847,848526,3075373
Palestine,PSE,2003,2291359,863610,3154969
Palestine,PSE,2004,2357720,878906,3236626
Palestine,PSE,2005,2425915,894481,3320396
Palestine,PSE,2006,2496025,910309,3406334
Palestine,PSE,2007,2568140,926356,3494496
Palestine,PSE,2008,2647431,944546,3591977
Palestine,PSE,2009,2727093,962006,3689099
Palestine,PSE,2010,2807401,978760,3786161
Palestine,PSE,2011,2888204,994782,3882986
Palestine,PSE,2012,2969835,1010163,3979998
Palestine,PSE,2013,3051946,1024762,4076708
Palestine,PSE,2014,3134764,1038634,4173398
Palestine,PSE,2015,3218283,1051809,4270092
Palestine,PSE,2016,3302741,1064347,4367088
Palestine,PSE,2017,3380930,1073875,4454805
Palestine,PSE,2018,3479999,1089088,4569087
Palestine,PSE,2019,3581448,1103858,4685306
Palestine,PSE,2020,3685020,1118249,4803269
Palestine,PSE,2021,3790664,1132085,4922749
Panama,PAN,1960,464872,662117,1126989
Panama,PAN,1961,485843,674989,1160832
Panama,PAN,1962,508351,687938,1196289
Panama,PAN,1963,531994,701273,1233267
Panama,PAN,1964,556696,714765,1271461
Panama,PAN,1965,582293,728263,1310556
Panama,PAN,1966,608788,741674,1350462
Panama,PAN,1967,636165,754907,1391072
Panama,PAN,1968,664351,767904,1432255
Panama,PAN,1969,693324,780641,1473965
Panama,PAN,1970,722312,793876,1516188
Panama,PAN,1971,747092,811980,1559072
Panama,PAN,1972,772459,830187,1602646
Panama,PAN,1973,798246,848334,1646580
Panama,PAN,1974,824357,866319,1690676
Panama,PAN,1975,850748,884128,1734876
Panama,PAN,1976,877403,901634,1779037
Panama,PAN,1977,904244,918902,1823146
Panama,PAN,1978,931397,935916,1867313
Panama,PAN,1979,958947,952867,1911814
Panama,PAN,1980,987241,969746,1956987
Panama,PAN,1981,1017290,985802,2003092
Panama,PAN,1982,1048209,1002038,2050247
Panama,PAN,1983,1079993,1018506,2098499
Panama,PAN,1984,1112552,1035025,2147577
Panama,PAN,1985,1145616,1051449,2197065
Panama,PAN,1986,1179250,1067710,2246960
Panama,PAN,1987,1213397,1083834,2297231
Panama,PAN,1988,1248078,1099743,2347821
Panama,PAN,1989,1283144,1115391,2398535
Panama,PAN,1990,1320606,1129362,2449968
Panama,PAN,1991,1370044,1132000,2502044
Panama,PAN,1992,1420466,1133916,2554382
Panama,PAN,1993,1472090,1135409,2607499
Panama,PAN,1994,1525000,1136385,2661385
Panama,PAN,1995,1579149,1136918,2716067
Panama,PAN,1996,1634638,1136968,2771606
Panama,PAN,1997,1691337,1136655,2827992
Panama,PAN,1998,1749341,1135836,2885177
Panama,PAN,1999,1808577,1134543,2943120
Panama,PAN,2000,1867017,1134714,3001731
Panama,PAN,2001,1913048,1147976,3061024
Panama,PAN,2002,1959794,1161196,3120990
Panama,PAN,2003,2007308,1174300,3181608
Panama,PAN,2004,2055838,1187473,3243311
Panama,PAN,2005,2105243,1200625,3305868
Panama,PAN,2006,2155078,1213495,3368573
Panama,PAN,2007,2205430,1226184,3431614
Panama,PAN,2008,2256550,1238726,3495276
Panama,PAN,2009,2308270,1251073,3559343
Panama,PAN,2010,2360424,1263193,3623617
Panama,PAN,2011,2413758,1274916,3688674
Panama,PAN,2012,2468484,1286378,3754862
Panama,PAN,2013,2524214,1297342,3821556
Panama,PAN,2014,2581031,1307762,3888793
Panama,PAN,2015,2639227,1317872,3957099
Panama,PAN,2016,2698732,1327604,4026336
Panama,PAN,2017,2759313,1336750,4096063
Panama,PAN,2018,2820253,1345002,4165255
Panama,PAN,2019,2880619,1351913,4232532
Panama,PAN,2020,2937968,1356428,4294396
Panama,PAN,2021,2992584,1358683,4351267
Papua New Guinea,PNG,1960,73966,1911700,1985666
Papua New Guinea,PNG,1961,81915,1953757,2035672
Papua New Guinea,PNG,1962,90529,1992033,2082562
Papua New Guinea,PNG,1963,99946,2029276,2129222
Papua New Guinea,PNG,1964,110271,2065138,2175409
Papua New Guinea,PNG,1965,121553,2100625,2222178
Papua New Guinea,PNG,1966,134063,2137427,2271490
Papua New Guinea,PNG,1967,155896,2166751,2322647
Papua New Guinea,PNG,1968,181121,2194235,2375356
Papua New Guinea,PNG,1969,210250,2220672,2430922
Papua New Guinea,PNG,1970,243828,2245231,2489059
Papua New Guinea,PNG,1971,282413,2266902,2549315
Papua New Guinea,PNG,1972,295009,2315691,2610700
Papua New Guinea,PNG,1973,307484,2364660,2672144
Papua New Guinea,PNG,1974,320262,2413051,2733313
Papua New Guinea,PNG,1975,333379,2461083,2794462
Papua New Guinea,PNG,1976,346899,2508938,2855837
Papua New Guinea,PNG,1977,360787,2556785,2917572
Papua New Guinea,PNG,1978,375132,2604474,2979606
Papua New Guinea,PNG,1979,389881,2652021,3041902
Papua New Guinea,PNG,1980,405082,2699706,3104788
Papua New Guinea,PNG,1981,419649,2749424,3169073
Papua New Guinea,PNG,1982,434431,2800833,3235264
Papua New Guinea,PNG,1983,449829,2853848,3303677
Papua New Guinea,PNG,1984,465879,2908586,3374465
Papua New Guinea,PNG,1985,482592,2964987,3447579
Papua New Guinea,PNG,1986,500007,3022909,3522916
Papua New Guinea,PNG,1987,518089,3082254,3600343
Papua New Guinea,PNG,1988,536824,3142827,3679651
Papua New Guinea,PNG,1989,556750,3207362,3764112
Papua New Guinea,PNG,1990,579514,3285458,3864972
Papua New Guinea,PNG,1991,591306,3399689,3990995
Papua New Guinea,PNG,1992,605150,3531494,4136644
Papua New Guinea,PNG,1993,619920,3671668,4291588
Papua New Guinea,PNG,1994,634901,3816793,4451694
Papua New Guinea,PNG,1995,650041,3966398,4616439
Papua New Guinea,PNG,1996,665287,4120608,4785895
Papua New Guinea,PNG,1997,680771,4279668,4960439
Papua New Guinea,PNG,1998,696260,4442569,5138829
Papua New Guinea,PNG,1999,711736,4609652,5321388
Papua New Guinea,PNG,2000,727316,4780981,5508297
Papua New Guinea,PNG,2001,751175,4947314,5698489
Papua New Guinea,PNG,2002,775701,5116895,5892596
Papua New Guinea,PNG,2003,800720,5290260,6090980
Papua New Guinea,PNG,2004,826104,5467062,6293166
Papua New Guinea,PNG,2005,851930,5646888,6498818
Papua New Guinea,PNG,2006,878173,5830044,6708217
Papua New Guinea,PNG,2007,904791,6016275,6921066
Papua New Guinea,PNG,2008,931864,6206124,7137988
Papua New Guinea,PNG,2009,959378,6399512,7358890
Papua New Guinea,PNG,2010,987266,6596003,7583269
Papua New Guinea,PNG,2011,1014863,6791774,7806637
Papua New Guinea,PNG,2012,1042006,6984539,8026545
Papua New Guinea,PNG,2013,1070117,7175510,8245627
Papua New Guinea,PNG,2014,1099324,7364829,8464153
Papua New Guinea,PNG,2015,1129724,7552450,8682174
Papua New Guinea,PNG,2016,1161342,7737827,8899169
Papua New Guinea,PNG,2017,1194221,7920575,9114796
Papua New Guinea,PNG,2018,1228566,8100661,9329227
Papua New Guinea,PNG,2019,1264379,8278107,9542486
Papua New Guinea,PNG,2020,1301089,8448551,9749640
Papua New Guinea,PNG,2021,1338796,8610641,9949437
Paraguay,PRY,1960,673972,1220857,1894829
Paraguay,PRY,1961,692429,1248779,1941208
Paraguay,PRY,1962,711620,1277756,1989376
Paraguay,PRY,1963,732467,1306923,2039390
Paraguay,PRY,1964,754354,1336486,2090840
Paraguay,PRY,1965,776743,1366410,2143153
Paraguay,PRY,1966,799481,1396474,2195955
Paraguay,PRY,1967,822439,1426443,2248882
Paraguay,PRY,1968,845598,1456289,2301887
Paraguay,PRY,1969,869040,1486082,2355122
Paraguay,PRY,1970,892817,1515970,2408787
Paraguay,PRY,1971,917264,1546513,2463777
Paraguay,PRY,1972,942943,1578565,2521508
Paraguay,PRY,1973,979431,1603729,2583160
Paraguay,PRY,1974,1018108,1629974,2648082
Paraguay,PRY,1975,1058203,1656461,2714664
Paraguay,PRY,1976,1099637,1682987,2782624
Paraguay,PRY,1977,1142569,1709861,2852430
Paraguay,PRY,1978,1187236,1737134,2924370
Paraguay,PRY,1979,1233989,1765426,2999415
Paraguay,PRY,1980,1283537,1795375,3078912
Paraguay,PRY,1981,1336019,1827280,3163299
Paraguay,PRY,1982,1391230,1860448,3251678
Paraguay,PRY,1983,1454726,1888550,3343276
Paraguay,PRY,1984,1521164,1916728,3437892
Paraguay,PRY,1985,1590373,1945125,3535498
Paraguay,PRY,1986,1662464,1973563,3636027
Paraguay,PRY,1987,1737275,2001775,3739050
Paraguay,PRY,1988,1814843,2029594,3844437
Paraguay,PRY,1989,1894603,2056685,3951288
Paraguay,PRY,1990,1976584,2082611,4059195
Paraguay,PRY,1991,2060616,2107380,4167996
Paraguay,PRY,1992,2146481,2130570,4277051
Paraguay,PRY,1993,2230121,2156081,4386202
Paraguay,PRY,1994,2314541,2180760,4495301
Paraguay,PRY,1995,2400068,2203849,4603917
Paraguay,PRY,1996,2486529,2225126,4711655
Paraguay,PRY,1997,2573641,2244648,4818289
Paraguay,PRY,1998,2661321,2262128,4923449
Paraguay,PRY,1999,2748887,2277144,5026031
Paraguay,PRY,2000,2835060,2288759,5123819
Paraguay,PRY,2001,2916691,2294850,5211541
Paraguay,PRY,2002,2992166,2294346,5286512
Paraguay,PRY,2003,3050124,2303130,5353254
Paraguay,PRY,2004,3103824,2312500,5416324
Paraguay,PRY,2005,3156489,2320389,5476878
Paraguay,PRY,2006,3207898,2326777,5534675
Paraguay,PRY,2007,3258272,2331873,5590145
Paraguay,PRY,2008,3308734,2336414,5645148
Paraguay,PRY,2009,3360926,2341648,5702574
Paraguay,PRY,2010,3418538,2350075,5768613
Paraguay,PRY,2011,3482053,2361886,5843939
Paraguay,PRY,2012,3548485,2374837,5923322
Paraguay,PRY,2013,3615222,2390430,6005652
Paraguay,PRY,2014,3683303,2407418,6090721
Paraguay,PRY,2015,3753105,2424845,6177950
Paraguay,PRY,2016,3824264,2442351,6266615
Paraguay,PRY,2017,3895863,2459541,6355404
Paraguay,PRY,2018,3968124,2475204,6443328
Paraguay,PRY,2019,4040715,2489311,6530026
Paraguay,PRY,2020,4115703,2502992,6618695
Paraguay,PRY,2021,4189606,2514193,6703799
Peru,PER,1960,4761712,5410495,10172207
Peru,PER,1961,4966408,5511688,10478096
Peru,PER,1962,5235676,5556418,10792094
Peru,PER,1963,5515438,5597227,11112665
Peru,PER,1964,5807197,5635104,11442301
Peru,PER,1965,6110870,5670711,11781581
Peru,PER,1966,6425773,5702217,12127990
Peru,PER,1967,6752060,5729566,12481626
Peru,PER,1968,7090372,5752877,12843249
Peru,PER,1969,7440524,5773215,13213739
Peru,PER,1970,7785615,5776756,13562371
Peru,PER,1971,8137945,5774023,13911968
Peru,PER,1972,8510717,5781720,14292437
Peru,PER,1973,8832460,5842325,14674785
Peru,PER,1974,9158828,5898347,15057175
Peru,PER,1975,9490498,5950999,15441497
Peru,PER,1976,9827343,5999470,15826813
Peru,PER,1977,10175915,6048698,16224613
Peru,PER,1978,10538980,6099500,16638480
Peru,PER,1979,10911055,6148130,17059185
Peru,PER,1980,11295546,6196860,17492406
Peru,PER,1981,11688660,6243684,17932344
Peru,PER,1982,12055425,6318947,18374372
Peru,PER,1983,12431594,6395312,18826906
Peru,PER,1984,12815119,6470527,19285646
Peru,PER,1985,13203373,6543237,19746610
Peru,PER,1986,13595630,6612807,20208437
Peru,PER,1987,13991823,6679537,20671360
Peru,PER,1988,14397870,6745929,21143799
Peru,PER,1989,14812437,6811874,21624311
Peru,PER,1990,15233390,6875709,22109099
Peru,PER,1991,15650023,6932983,22583006
Peru,PER,1992,16063240,6984008,23047248
Peru,PER,1993,16480645,7033237,23513882
Peru,PER,1994,16913233,7070025,23983258
Peru,PER,1995,17346849,7102206,24449055
Peru,PER,1996,17778086,7129218,24907304
Peru,PER,1997,18211840,7153546,25365386
Peru,PER,1998,18644890,7173336,25818226
Peru,PER,1999,19067264,7184975,26252239
Peru,PER,2000,19468935,7185504,26654439
Peru,PER,2001,19841910,7172999,27014909
Peru,PER,2002,20186530,7147973,27334503
Peru,PER,2003,20510054,7113287,27623341
Peru,PER,2004,20821131,7072780,27893911
Peru,PER,2005,21120020,7027247,28147267
Peru,PER,2006,21405293,6975785,28381078
Peru,PER,2007,21679951,6920436,28600387
Peru,PER,2008,21907680,6898505,28806185
Peru,PER,2009,22117000,6892326,29009326
Peru,PER,2010,22340162,6889410,29229572
Peru,PER,2011,22584945,6892776,29477721
Peru,PER,2012,22848874,6900715,29749589
Peru,PER,2013,23126579,6912230,30038809
Peru,PER,2014,23425055,6928896,30353951
Peru,PER,2015,23757776,6954087,30711863
Peru,PER,2016,24140046,6992733,31132779
Peru,PER,2017,24563784,7041702,31605486
Peru,PER,2018,25089127,7114817,32203944
Peru,PER,2019,25635888,7188973,32824861
Peru,PER,2020,26076625,7228131,33304756
Peru,PER,2021,26466645,7248826,33715471
Philippines,PHL,1960,8630667,19856204,28486871
Philippines,PHL,1961,8965574,20376836,29342410
Philippines,PHL,1962,9302111,20883868,30185979
Philippines,PHL,1963,9647454,21396256,31043710
Philippines,PHL,1964,10002669,21913952,31916621
Philippines,PHL,1965,10367862,22437676,32805538
Philippines,PHL,1966,10741366,22963384,33704750
Philippines,PHL,1967,11124127,23492730,34616857
Philippines,PHL,1968,11517638,24027336,35544974
Philippines,PHL,1969,11917821,24559348,36477169
Philippines,PHL,1970,12345882,25089704,37435586
Philippines,PHL,1971,12868595,25553152,38421747
Philippines,PHL,1972,13404972,26007508,39412480
Philippines,PHL,1973,13953485,26452748,40406233
Philippines,PHL,1974,14510333,26877992,41388325
Philippines,PHL,1975,15075460,27318972,42394432
Philippines,PHL,1976,15614689,27859680,43474369
Philippines,PHL,1977,16195524,28450994,44646518
Philippines,PHL,1978,16812072,29078668,45890740
Philippines,PHL,1979,17445651,29708580,47154231
Philippines,PHL,1980,18136025,30283520,48419545
Philippines,PHL,1981,19073882,30605448,49679330
Philippines,PHL,1982,20040743,30897780,50938523
Philippines,PHL,1983,21044533,31175152,52219685
Philippines,PHL,1984,22083483,31431476,53514959
Philippines,PHL,1985,23150127,31662532,54812659
Philippines,PHL,1986,24246183,31863656,56109839
Philippines,PHL,1987,25374637,32040538,57415175
Philippines,PHL,1988,26547689,32208234,58755923
Philippines,PHL,1989,27761997,32365346,60127343
Philippines,PHL,1990,28924064,32634834,61558898
Philippines,PHL,1991,29566274,33473476,63039750
Philippines,PHL,1992,30216051,34327470,64543521
Philippines,PHL,1993,30880736,35202584,66083320
Philippines,PHL,1994,31555475,36094810,67650285
Philippines,PHL,1995,32243018,37007450,69250468
Philippines,PHL,1996,32971674,37973296,70944970
Philippines,PHL,1997,33734268,38984570,72718838
Philippines,PHL,1998,34493483,39998436,74491919
Philippines,PHL,1999,35242317,41006748,76249065
Philippines,PHL,2000,35966026,41992196,77958222
Philippines,PHL,2001,36667813,42958270,79626083
Philippines,PHL,2002,37362913,43922660,81285573
Philippines,PHL,2003,38054174,44888664,82942838
Philippines,PHL,2004,38746005,45861496,84607501
Philippines,PHL,2005,39430017,46831230,86261247
Philippines,PHL,2006,40105212,47796624,87901836
Philippines,PHL,2007,40786251,48775130,89561381
Philippines,PHL,2008,41478745,49773580,91252325
Philippines,PHL,2009,42170961,50775990,92946951
Philippines,PHL,2010,42900709,51735990,94636699
Philippines,PHL,2011,43854945,52482970,96337915
Philippines,PHL,2012,44812533,53219784,98032317
Philippines,PHL,2013,45765340,53934770,99700110
Philippines,PHL,2014,46703825,54621376,101325201
Philippines,PHL,2015,47687037,55344330,103031367
Philippines,PHL,2016,48740780,56134490,104875270
Philippines,PHL,2017,49827667,56910830,106738497
Philippines,PHL,2018,50926384,57642452,108568836
Philippines,PHL,2019,52043445,58337360,110380805
Philippines,PHL,2020,53187498,59003480,112190978
Philippines,PHL,2021,54302696,59577630,113880326
Poland,POL,1960,14193968,15443482,29637450
Poland,POL,1961,14540630,15423370,29964000
Poland,POL,1962,14828737,15479763,30308500
Poland,POL,1963,15149001,15562999,30712000
Poland,POL,1964,15484714,15654736,31139450
Poland,POL,1965,15762096,15682854,31444950
Poland,POL,1966,16007142,15673858,31681000
Poland,POL,1967,16289779,15697376,31987155
Poland,POL,1968,16575555,15719100,32294655
Poland,POL,1969,16835934,15712366,32548300
Poland,POL,1970,17026266,15638034,32664300
Poland,POL,1971,17266414,15517086,32783500
Poland,POL,1972,17626595,15429055,33055650
Poland,POL,1973,18005216,15351984,33357200
Poland,POL,1974,18398446,15280453,33678899
Poland,POL,1975,18803602,15211597,34015199
Poland,POL,1976,19215135,15141165,34356300
Poland,POL,1977,19625330,15063720,34689050
Poland,POL,1978,20007316,14958284,34965600
Poland,POL,1979,20341874,14905343,35247217
Poland,POL,1980,20663601,14910549,35574150
Poland,POL,1981,20985955,14912632,35898587
Poland,POL,1982,21314754,14915727,36230481
Poland,POL,1983,21651242,14920566,36571808
Poland,POL,1984,21984900,14919234,36904134
Poland,POL,1985,22299554,14902331,37201885
Poland,POL,1986,22589785,14866334,37456119
Poland,POL,1987,22855463,14812582,37668045
Poland,POL,1988,23089202,14735285,37824487
Poland,POL,1989,23241946,14719583,37961529
Poland,POL,1990,23350476,14760306,38110782
Poland,POL,1991,23450653,14795540,38246193
Poland,POL,1992,23539562,14824105,38363667
Poland,POL,1993,23616843,14844565,38461408
Poland,POL,1994,23684074,14858578,38542652
Poland,POL,1995,23733222,14861776,38594998
Poland,POL,1996,23768665,14855705,38624370
Poland,POL,1997,23801620,14848040,38649660
Poland,POL,1998,23827143,14836338,38663481
Poland,POL,1999,23842562,14817709,38660271
Poland,POL,2000,23611695,14646934,38258629
Poland,POL,2001,23622394,14625682,38248076
Poland,POL,2002,23621395,14608969,38230364
Poland,POL,2003,23563051,14641519,38204570
Poland,POL,2004,23506503,14675719,38182222
Poland,POL,2005,23453429,14712016,38165445
Poland,POL,2006,23396235,14745032,38141267
Poland,POL,2007,23340838,14779722,38120560
Poland,POL,2008,23300939,14824820,38125759
Poland,POL,2009,23274004,14877599,38151603
Poland,POL,2010,23165018,14877776,38042794
Poland,POL,2011,23134846,14928409,38063255
Poland,POL,2012,23086831,14976333,38063164
Poland,POL,2013,23025350,15014846,38040196
Poland,POL,2014,22960228,15051507,38011735
Poland,POL,2015,22897449,15088963,37986412
Poland,POL,2016,22849639,15120448,37970087
Poland,POL,2017,22824769,15150057,37974826
Poland,POL,2018,22806875,15167875,37974750
Poland,POL,2019,22793332,15172143,37965475
Poland,POL,2020,22755739,15143331,37899070
Poland,POL,2021,22676585,15070539,37747124
Portugal,PRT,1960,3096215,5761501,8857716
Portugal,PRT,1961,3155977,5773339,8929316
Portugal,PRT,1962,3212831,5781154,8993985
Portugal,PRT,1963,3260048,5770307,9030355
Portugal,PRT,1964,3296372,5738993,9035365
Portugal,PRT,1965,3317422,5681173,8998595
Portugal,PRT,1966,3326794,5604196,8930990
Portugal,PRT,1967,3340014,5534506,8874520
Portugal,PRT,1968,3360136,5476514,8836650
Portugal,PRT,1969,3364185,5393520,8757705
Portugal,PRT,1970,3368354,5312077,8680431
Portugal,PRT,1971,3388093,5255663,8643756
Portugal,PRT,1972,3416874,5213556,8630430
Portugal,PRT,1973,3451945,5181155,8633100
Portugal,PRT,1974,3535188,5219177,8754365
Portugal,PRT,1975,3708226,5385244,9093470
Portugal,PRT,1976,3852629,5503181,9355810
Portugal,PRT,1977,3931481,5524194,9455675
Portugal,PRT,1978,4012458,5545792,9558250
Portugal,PRT,1979,4094541,5566724,9661265
Portugal,PRT,1980,4178517,5587795,9766312
Portugal,PRT,1981,4257857,5593505,9851362
Portugal,PRT,1982,4335210,5576561,9911771
Portugal,PRT,1983,4407052,5550813,9957865
Portugal,PRT,1984,4476013,5520219,9996232
Portugal,PRT,1985,4540496,5483117,10023613
Portugal,PRT,1986,4596999,5435735,10032734
Portugal,PRT,1987,4648117,5381914,10030031
Portugal,PRT,1988,4695891,5323719,10019610
Portugal,PRT,1989,4741470,5263530,10005000
Portugal,PRT,1990,4783459,5199759,9983218
Portugal,PRT,1991,4827626,5132609,9960235
Portugal,PRT,1992,4889660,5062834,9952494
Portugal,PRT,1993,4961312,5003363,9964675
Portugal,PRT,1994,5040624,4950901,9991525
Portugal,PRT,1995,5124278,4901898,10026176
Portugal,PRT,1996,5210104,4853841,10063945
Portugal,PRT,1997,5299934,4809043,10108977
Portugal,PRT,1998,5393642,4766554,10160196
Portugal,PRT,1999,5491367,4726461,10217828
Portugal,PRT,2000,5597602,4692296,10289898
Portugal,PRT,2001,5704057,4658665,10362722
Portugal,PRT,2002,5800192,4619439,10419631
Portugal,PRT,2003,5886957,4571864,10458821
Portugal,PRT,2004,5966051,4517810,10483861
Portugal,PRT,2005,6041725,4461605,10503330
Portugal,PRT,2006,6117343,4404945,10522288
Portugal,PRT,2007,6193886,4349078,10542964
Portugal,PRT,2008,6267228,4290949,10558177
Portugal,PRT,2009,6337144,4231103,10568247
Portugal,PRT,2010,6403809,4169291,10573100
Portugal,PRT,2011,6457743,4099817,10557560
Portugal,PRT,2012,6494283,4020561,10514844
Portugal,PRT,2013,6520333,3936962,10457295
Portugal,PRT,2014,6546012,3855050,10401062
Portugal,PRT,2015,6578828,3779248,10358076
Portugal,PRT,2016,6617169,3708283,10325452
Portugal,PRT,2017,6659350,3640950,10300300
Portugal,PRT,2018,6706183,3577639,10283822
Portugal,PRT,2019,6764658,3521605,10286263
Portugal,PRT,2020,6827994,3469087,10297081
Portugal,PRT,2021,6902258,3422889,10325147
Puerto Rico,PRI,1960,1050418,1307582,2358000
Puerto Rico,PRI,1961,1102264,1297458,2399722
Puerto Rico,PRI,1962,1159664,1290658,2450322
Puerto Rico,PRI,1963,1220307,1284223,2504530
Puerto Rico,PRI,1964,1280251,1273815,2554066
Puerto Rico,PRI,1965,1336533,1257467,2594000
Puerto Rico,PRI,1966,1389174,1235821,2624995
Puerto Rico,PRI,1967,1436971,1208703,2645674
Puerto Rico,PRI,1968,1482823,1179241,2662064
Puerto Rico,PRI,1969,1532032,1152118,2684150
Puerto Rico,PRI,1970,1585355,1132645,2718000
Puerto Rico,PRI,1971,1636045,1126145,2762190
Puerto Rico,PRI,1972,1693932,1123324,2817256
Puerto Rico,PRI,1973,1756462,1122324,2878786
Puerto Rico,PRI,1974,1819309,1119990,2939299
Puerto Rico,PRI,1975,1879334,1114666,2994000
Puerto Rico,PRI,1976,1937017,1106837,3043854
Puerto Rico,PRI,1977,1991958,1096732,3088690
Puerto Rico,PRI,1978,2044764,1084657,3129421
Puerto Rico,PRI,1979,2096577,1071511,3168088
Puerto Rico,PRI,1980,2174790,1031210,3206000
Puerto Rico,PRI,1981,2327244,915308,3242552
Puerto Rico,PRI,1982,2471396,806057,3277453
Puerto Rico,PRI,1983,2606230,704908,3311138
Puerto Rico,PRI,1984,2731668,612522,3344190
Puerto Rico,PRI,1985,2847385,529615,3377000
Puerto Rico,PRI,1986,2953935,455619,3409554
Puerto Rico,PRI,1987,3051544,390306,3441850
Puerto Rico,PRI,1988,3140855,333043,3473898
Puerto Rico,PRI,1989,3222218,283432,3505650
Puerto Rico,PRI,1990,3287359,249641,3537000
Puerto Rico,PRI,1991,3316538,245572,3562110
Puerto Rico,PRI,1992,3343786,241390,3585176
Puerto Rico,PRI,1993,3377742,237755,3615497
Puerto Rico,PRI,1994,3414883,234354,3649237
Puerto Rico,PRI,1995,3452136,230967,3683103
Puerto Rico,PRI,1996,3496557,228098,3724655
Puerto Rico,PRI,1997,3534616,224814,3759430
Puerto Rico,PRI,1998,3560323,220778,3781101
Puerto Rico,PRI,1999,3583400,216681,3800081
Puerto Rico,PRI,2000,3596716,213889,3810605
Puerto Rico,PRI,2001,3602364,216410,3818774
Puerto Rico,PRI,2002,3604909,218792,3823701
Puerto Rico,PRI,2003,3605100,220995,3826095
Puerto Rico,PRI,2004,3603694,223184,3826878
Puerto Rico,PRI,2005,3596360,225002,3821362
Puerto Rico,PRI,2006,3579032,226182,3805214
Puerto Rico,PRI,2007,3555977,227018,3782995
Puerto Rico,PRI,2008,3533033,227833,3760866
Puerto Rico,PRI,2009,3511647,228763,3740410
Puerto Rico,PRI,2010,3491721,229804,3721525
Puerto Rico,PRI,2011,3449657,229075,3678732
Puerto Rico,PRI,2012,3406460,228028,3634488
Puerto Rico,PRI,2013,3366210,226867,3593077
Puerto Rico,PRI,2014,3310445,224429,3534874
Puerto Rico,PRI,2015,3251779,221453,3473232
Puerto Rico,PRI,2016,3188713,217959,3406672
Puerto Rico,PRI,2017,3112035,213251,3325286
Puerto Rico,PRI,2018,2988277,205077,3193354
Puerto Rico,PRI,2019,2988531,205163,3193694
Puerto Rico,PRI,2020,3070896,210642,3281538
Puerto Rico,PRI,2021,3054454,209130,3263584
Qatar,QAT,1960,31027,5358,36385
Qatar,QAT,1961,34372,5739,40111
Qatar,QAT,1962,38851,6272,45123
Qatar,QAT,1963,44072,6878,50950
Qatar,QAT,1964,49925,7606,57531
Qatar,QAT,1965,56448,8395,64843
Qatar,QAT,1966,63835,9267,73102
Qatar,QAT,1967,72275,10242,82517
Qatar,QAT,1968,81718,11304,93022
Qatar,QAT,1969,92083,12434,104517
Qatar,QAT,1970,104264,13743,118007
Qatar,QAT,1971,117923,15173,133096
Qatar,QAT,1972,131543,16795,148338
Qatar,QAT,1973,145322,18412,163734
Qatar,QAT,1974,159275,20024,179299
Qatar,QAT,1975,173411,21632,195043
Qatar,QAT,1976,187749,23241,210990
Qatar,QAT,1977,202324,24853,227177
Qatar,QAT,1978,217154,26470,243624
Qatar,QAT,1979,232274,28094,260368
Qatar,QAT,1980,247938,29512,277450
Qatar,QAT,1981,263965,30922,294887
Qatar,QAT,1982,280294,32314,312608
Qatar,QAT,1983,296784,33670,330454
Qatar,QAT,1984,313264,34977,348241
Qatar,QAT,1985,329647,36221,365868
Qatar,QAT,1986,345625,36703,382328
Qatar,QAT,1987,361848,35543,397391
Qatar,QAT,1988,377815,34327,412142
Qatar,QAT,1989,393799,33097,426896
Qatar,QAT,1990,409813,31862,441675
Qatar,QAT,1991,425860,30626,456486
Qatar,QAT,1992,441898,29395,471293
Qatar,QAT,1993,457865,28176,486041
Qatar,QAT,1994,473716,26967,500683
Qatar,QAT,1995,489366,25767,515133
Qatar,QAT,1996,504686,24579,529265
Qatar,QAT,1997,526690,23901,550591
Qatar,QAT,1998,557106,23891,580997
Qatar,QAT,1999,589414,23888,613302
Qatar,QAT,2000,622108,23829,645937
Qatar,QAT,2001,655113,23718,678831
Qatar,QAT,2002,689594,23592,713186
Qatar,QAT,2003,725081,23444,748525
Qatar,QAT,2004,755305,22638,777943
Qatar,QAT,2005,826610,22100,848710
Qatar,QAT,2006,991419,23641,1015060
Qatar,QAT,2007,1206233,25660,1231893
Qatar,QAT,2008,1417399,26878,1444277
Qatar,QAT,2009,1583479,26795,1610274
Qatar,QAT,2010,1687819,25685,1713504
Qatar,QAT,2011,1778949,25222,1804171
Qatar,QAT,2012,1880829,24831,1905660
Qatar,QAT,2013,2010770,24731,2035501
Qatar,QAT,2014,2189397,25068,2214465
Qatar,QAT,2015,2389099,25474,2414573
Qatar,QAT,2016,2569604,25562,2595166
Qatar,QAT,2017,2686753,25002,2711755
Qatar,QAT,2018,2742800,23932,2766732
Qatar,QAT,2019,2784440,22795,2807235
Qatar,QAT,2020,2739268,21117,2760385
Qatar,QAT,2021,2668826,19409,2688235
Romania,ROU,1960,6296818,12110087,18406905
Romania,ROU,1961,6474669,12080581,18555250
Romania,ROU,1962,6646237,12030313,18676550
Romania,ROU,1963,6820612,11977238,18797850
Romania,ROU,1964,6997996,11921130,18919126
Romania,ROU,1965,7174333,11857243,19031576
Romania,ROU,1966,7368164,11847286,19215450
Romania,ROU,1967,7586123,11948119,19534242
Romania,ROU,1968,7786878,12012953,19799831
Romania,ROU,1969,7968040,12041101,20009141
Romania,ROU,1970,8164758,12085640,20250398
Romania,ROU,1971,8352002,12109565,20461567
Romania,ROU,1972,8535661,12122296,20657957
Romania,ROU,1973,8713690,12121991,20835681
Romania,ROU,1974,8900706,12128723,21029429
Romania,ROU,1975,9120255,12173328,21293583
Romania,ROU,1976,9340263,12211371,21551634
Romania,ROU,1977,9560064,12196032,21756096
Romania,ROU,1978,9801109,12150355,21951464
Romania,ROU,1979,10019804,12070684,22090488
Romania,ROU,1980,10230895,11976387,22207282
Romania,ROU,1981,10456990,11896080,22353070
Romania,ROU,1982,10674853,11800888,22475741
Romania,ROU,1983,10876406,11684072,22560478
Romania,ROU,1984,11077114,11563433,22640547
Romania,ROU,1985,11284888,11448111,22732999
Romania,ROU,1986,11499948,11336893,22836841
Romania,ROU,1987,11720962,11228468,22949430
Romania,ROU,1988,11941563,11116099,23057662
Romania,ROU,1989,12160692,11000766,23161458
Romania,ROU,1990,12347321,10854514,23201835
Romania,ROU,1991,12404523,10596632,23001155
Romania,ROU,1992,12360656,10433628,22794284
Romania,ROU,1993,12309016,10454264,22763280
Romania,ROU,1994,12256584,10473627,22730211
Romania,ROU,1995,12197105,10487165,22684270
Romania,ROU,1996,12127405,10491599,22619004
Romania,ROU,1997,12058033,10495945,22553978
Romania,ROU,1998,11998890,10508454,22507344
Romania,ROU,1999,11945687,10526353,22472040
Romania,ROU,2000,11895672,10547299,22442971
Romania,ROU,2001,11697189,10434781,22131970
Romania,ROU,2002,11469356,10261140,21730496
Romania,ROU,2003,11415407,10158919,21574326
Romania,ROU,2004,11378651,10073097,21451748
Romania,ROU,2005,11336529,9983156,21319685
Romania,ROU,2006,11297334,9896426,21193760
Romania,ROU,2007,11159030,9723952,20882982
Romania,ROU,2008,11001524,9536351,20537875
Romania,ROU,2009,10936933,9430554,20367487
Romania,ROU,2010,10898688,9348183,20246871
Romania,ROU,2011,10871606,9275922,20147528
Romania,ROU,2012,10826124,9231911,20058035
Romania,ROU,2013,10778604,9205089,19983693
Romania,ROU,2014,10730940,9178039,19908979
Romania,ROU,2015,10678041,9137575,19815616
Romania,ROU,2016,10619522,9082745,19702267
Romania,ROU,2017,10565369,9023346,19588715
Romania,ROU,2018,10515554,8958416,19473970
Romania,ROU,2019,10476962,8894686,19371648
Romania,ROU,2020,10440610,8824640,19265250
Romania,ROU,2021,10387640,8732240,19119880
Russia,RUS,1960,64421857,55475144,119897001
Russia,RUS,1961,66226377,55009624,121236001
Russia,RUS,1962,68060071,54530930,122591001
Russia,RUS,1963,69923357,54036644,123960001
Russia,RUS,1964,71815164,53529836,125345000
Russia,RUS,1965,73731369,53013630,126744999
Russia,RUS,1966,75267305,52200696,127468001
Russia,RUS,1967,76812479,51383520,128195999
Russia,RUS,1968,78366306,50561696,128928002
Russia,RUS,1969,79922296,49741704,129664000
Russia,RUS,1970,81464683,48939316,130403999
Russia,RUS,1971,82992261,48162740,131155001
Russia,RUS,1972,84524649,47384350,131908999
Russia,RUS,1973,86061054,46607944,132668998
Russia,RUS,1974,87600777,45831224,133432001
Russia,RUS,1975,89145034,45054970,134200004
Russia,RUS,1976,90810675,44336324,135146999
Russia,RUS,1977,92479950,43620050,136100000
Russia,RUS,1978,94157479,42902520,137059999
Russia,RUS,1979,95659612,42367388,138027000
Russia,RUS,1980,96960865,42049136,139010001
Russia,RUS,1981,98228786,41712216,139941002
Russia,RUS,1982,99464693,41358308,140823001
Russia,RUS,1983,100677781,40990220,141668001
Russia,RUS,1984,102058393,40686610,142745003
Russia,RUS,1985,103466989,40391012,143858001
Russia,RUS,1986,104825013,40068988,144894001
Russia,RUS,1987,106169956,39738044,145908000
Russia,RUS,1988,107471421,39385580,146857001
Russia,RUS,1989,108424260,39296740,147721000
Russia,RUS,1990,108600667,39368740,147969407
Russia,RUS,1991,108905031,39489184,148394215
Russia,RUS,1992,109004756,39533440,148538196
Russia,RUS,1993,108940535,39518240,148458775
Russia,RUS,1994,108895790,39512120,148407910
Russia,RUS,1995,108866282,39509504,148375786
Russia,RUS,1996,108700642,39459490,148160132
Russia,RUS,1997,108515146,39400216,147915362
Russia,RUS,1998,108329810,39340976,147670786
Russia,RUS,1999,107987927,39226850,147214777
Russia,RUS,2000,107528803,39068064,146596867
Russia,RUS,2001,107067910,38908572,145976482
Russia,RUS,2002,106569238,38737260,145306498
Russia,RUS,2003,106133030,38515588,144648618
Russia,RUS,2004,105771342,38295976,144067318
Russia,RUS,2005,105433226,38085588,143518814
Russia,RUS,2006,105152927,37896710,143049637
Russia,RUS,2007,105037446,37767668,142805114
Russia,RUS,2008,105055527,37686840,142742367
Russia,RUS,2009,105149987,37635360,142785347
Russia,RUS,2010,105261487,37587980,142849467
Russia,RUS,2011,105407937,37552972,142960909
Russia,RUS,2012,105669982,37531740,143201722
Russia,RUS,2013,105998572,37508424,143506996
Russia,RUS,2014,106354644,37465024,143819668
Russia,RUS,2015,106703732,37393136,144096868
Russia,RUS,2016,107050095,37292304,144342399
Russia,RUS,2017,107349517,37147224,144496741
Russia,RUS,2018,107539205,36938656,144477861
Russia,RUS,2019,107708298,36697964,144406262
Russia,RUS,2020,107700434,36372704,144073138
Russia,RUS,2021,107492288,35957000,143449288
Rwanda,RWA,1960,77120,2889042,2966162
Rwanda,RWA,1961,80858,2965796,3046654
Rwanda,RWA,1962,84610,3037514,3122124
Rwanda,RWA,1963,88272,3103039,3191311
Rwanda,RWA,1964,92165,3171475,3263640
Rwanda,RWA,1965,96508,3252123,3348631
Rwanda,RWA,1966,101323,3342698,3444021
Rwanda,RWA,1967,106590,3442871,3549461
Rwanda,RWA,1968,112277,3549733,3662010
Rwanda,RWA,1969,118210,3659669,3777879
Rwanda,RWA,1970,124450,3771917,3896367
Rwanda,RWA,1971,133954,3881449,4015403
Rwanda,RWA,1972,144373,3991206,4135579
Rwanda,RWA,1973,155556,4103928,4259484
Rwanda,RWA,1974,167603,4218766,4386369
Rwanda,RWA,1975,180540,4335216,4515756
Rwanda,RWA,1976,194388,4453819,4648207
Rwanda,RWA,1977,209219,4574033,4783252
Rwanda,RWA,1978,225179,4696774,4921953
Rwanda,RWA,1979,236263,4838111,5074374
Rwanda,RWA,1980,247736,4999796,5247532
Rwanda,RWA,1981,260452,5181514,5441966
Rwanda,RWA,1982,274335,5378565,5652900
Rwanda,RWA,1983,288282,5571114,5859396
Rwanda,RWA,1984,302110,5754619,6056729
Rwanda,RWA,1985,316910,5949842,6266752
Rwanda,RWA,1986,333142,6164662,6497804
Rwanda,RWA,1987,350128,6385701,6735829
Rwanda,RWA,1988,366474,6587501,6953975
Rwanda,RWA,1989,381524,6760450,7141974
Rwanda,RWA,1990,396449,6923513,7319962
Rwanda,RWA,1991,411039,7074642,7485681
Rwanda,RWA,1992,481485,7175723,7657208
Rwanda,RWA,1993,578074,7326666,7904740
Rwanda,RWA,1994,571603,6161062,6732665
Rwanda,RWA,1995,559420,5127477,5686897
Rwanda,RWA,1996,763822,5951688,6715510
Rwanda,RWA,1997,955735,6710997,7666732
Rwanda,RWA,1998,1048216,6866429,7914645
Rwanda,RWA,1999,1126468,6883119,8009587
Rwanda,RWA,2000,1210497,6899492,8109989
Rwanda,RWA,2001,1301768,6922173,8223941
Rwanda,RWA,2002,1404622,6967684,8372306
Rwanda,RWA,2003,1448333,7119659,8567992
Rwanda,RWA,2004,1486527,7305326,8791853
Rwanda,RWA,2005,1526528,7499771,9026299
Rwanda,RWA,2006,1568217,7701849,9270066
Rwanda,RWA,2007,1611415,7911753,9523168
Rwanda,RWA,2008,1655603,8126393,9781996
Rwanda,RWA,2009,1700405,8343332,10043737
Rwanda,RWA,2010,1745731,8563300,10309031
Rwanda,RWA,2011,1791521,8785411,10576932
Rwanda,RWA,2012,1836678,9003656,10840334
Rwanda,RWA,2013,1881346,9220004,11101350
Rwanda,RWA,2014,1928885,9439566,11368451
Rwanda,RWA,2015,1979769,9663190,11642959
Rwanda,RWA,2016,2034934,9895965,11930899
Rwanda,RWA,2017,2094446,10135893,12230339
Rwanda,RWA,2018,2156849,10374959,12531808
Rwanda,RWA,2019,2222128,10612900,12835028
Rwanda,RWA,2020,2291674,10854688,13146362
Rwanda,RWA,2021,2364984,11096904,13461888
Saint Kitts and Nevis,KNA,1960,15663,40997,56660
Saint Kitts and Nevis,KNA,1961,15900,40347,56247
Saint Kitts and Nevis,KNA,1962,16013,39391,55404
Saint Kitts and Nevis,KNA,1963,16070,38321,54391
Saint Kitts and Nevis,KNA,1964,16081,37174,53255
Saint Kitts and Nevis,KNA,1965,16050,35966,52016
Saint Kitts and Nevis,KNA,1966,15976,34707,50683
Saint Kitts and Nevis,KNA,1967,15863,33406,49269
Saint Kitts and Nevis,KNA,1968,15706,32066,47772
Saint Kitts and Nevis,KNA,1969,15486,30649,46135
Saint Kitts and Nevis,KNA,1970,15353,29615,44968
Saint Kitts and Nevis,KNA,1971,15300,29283,44583
Saint Kitts and Nevis,KNA,1972,15321,29095,44416
Saint Kitts and Nevis,KNA,1973,15340,28902,44242
Saint Kitts and Nevis,KNA,1974,15353,28703,44056
Saint Kitts and Nevis,KNA,1975,15373,28515,43888
Saint Kitts and Nevis,KNA,1976,15399,28341,43740
Saint Kitts and Nevis,KNA,1977,15429,28174,43603
Saint Kitts and Nevis,KNA,1978,15458,28007,43465
Saint Kitts and Nevis,KNA,1979,15469,27809,43278
Saint Kitts and Nevis,KNA,1980,15464,27633,43097
Saint Kitts and Nevis,KNA,1981,15357,27596,42953
Saint Kitts and Nevis,KNA,1982,15246,27548,42794
Saint Kitts and Nevis,KNA,1983,15122,27478,42600
Saint Kitts and Nevis,KNA,1984,14990,27390,42380
Saint Kitts and Nevis,KNA,1985,14853,27291,42144
Saint Kitts and Nevis,KNA,1986,14710,27179,41889
Saint Kitts and Nevis,KNA,1987,14561,27056,41617
Saint Kitts and Nevis,KNA,1988,14405,26916,41321
Saint Kitts and Nevis,KNA,1989,14239,26753,40992
Saint Kitts and Nevis,KNA,1990,14064,26572,40636
Saint Kitts and Nevis,KNA,1991,13976,26566,40542
Saint Kitts and Nevis,KNA,1992,14022,26878,40900
Saint Kitts and Nevis,KNA,1993,14131,27316,41447
Saint Kitts and Nevis,KNA,1994,14240,27761,42001
Saint Kitts and Nevis,KNA,1995,14346,28204,42550
Saint Kitts and Nevis,KNA,1996,14449,28648,43097
Saint Kitts and Nevis,KNA,1997,14554,29102,43656
Saint Kitts and Nevis,KNA,1998,14663,29567,44230
Saint Kitts and Nevis,KNA,1999,14777,30048,44825
Saint Kitts and Nevis,KNA,2000,14901,30560,45461
Saint Kitts and Nevis,KNA,2001,14991,30995,45986
Saint Kitts and Nevis,KNA,2002,15015,31249,46264
Saint Kitts and Nevis,KNA,2003,15003,31428,46431
Saint Kitts and Nevis,KNA,2004,14985,31595,46580
Saint Kitts and Nevis,KNA,2005,14965,31760,46725
Saint Kitts and Nevis,KNA,2006,14946,31928,46874
Saint Kitts and Nevis,KNA,2007,14924,32091,47015
Saint Kitts and Nevis,KNA,2008,14903,32253,47156
Saint Kitts and Nevis,KNA,2009,14878,32408,47286
Saint Kitts and Nevis,KNA,2010,14848,32555,47403
Saint Kitts and Nevis,KNA,2011,14837,32744,47581
Saint Kitts and Nevis,KNA,2012,14825,32902,47727
Saint Kitts and Nevis,KNA,2013,14791,32976,47767
Saint Kitts and Nevis,KNA,2014,14760,33029,47789
Saint Kitts and Nevis,KNA,2015,14732,33058,47790
Saint Kitts and Nevis,KNA,2016,14714,33074,47788
Saint Kitts and Nevis,KNA,2017,14705,33080,47785
Saint Kitts and Nevis,KNA,2018,14699,33062,47761
Saint Kitts and Nevis,KNA,2019,14695,33017,47712
Saint Kitts and Nevis,KNA,2020,14694,32948,47642
Saint Kitts and Nevis,KNA,2021,14713,32893,47606
Saint Lucia,LCA,1960,19660,71954,91614
Saint Lucia,LCA,1961,20125,72636,92761
Saint Lucia,LCA,1962,20579,73244,93823
Saint Lucia,LCA,1963,21040,73847,94887
Saint Lucia,LCA,1964,21508,74440,95948
Saint Lucia,LCA,1965,21986,75038,97024
Saint Lucia,LCA,1966,22476,75650,98126
Saint Lucia,LCA,1967,22981,76276,99257
Saint Lucia,LCA,1968,23497,76903,100400
Saint Lucia,LCA,1969,24034,77571,101605
Saint Lucia,LCA,1970,24646,78444,103090
Saint Lucia,LCA,1971,25317,79464,104781
Saint Lucia,LCA,1972,25996,80461,106457
Saint Lucia,LCA,1973,26679,81435,108114
Saint Lucia,LCA,1974,27367,82373,109740
Saint Lucia,LCA,1975,28097,83400,111497
Saint Lucia,LCA,1976,28883,84538,113421
Saint Lucia,LCA,1977,29689,85696,115385
Saint Lucia,LCA,1978,30521,86876,117397
Saint Lucia,LCA,1979,31381,88082,119463
Saint Lucia,LCA,1980,32281,89352,121633
Saint Lucia,LCA,1981,33222,90687,123909
Saint Lucia,LCA,1982,34182,92012,126194
Saint Lucia,LCA,1983,35146,93294,128440
Saint Lucia,LCA,1984,36109,94516,130625
Saint Lucia,LCA,1985,37068,95683,132751
Saint Lucia,LCA,1986,38023,96787,134810
Saint Lucia,LCA,1987,38966,97814,136780
Saint Lucia,LCA,1988,39898,98762,138660
Saint Lucia,LCA,1989,40818,99639,140457
Saint Lucia,LCA,1990,41764,100537,142301
Saint Lucia,LCA,1991,42663,101605,144268
Saint Lucia,LCA,1992,43002,103418,146420
Saint Lucia,LCA,1993,43341,105254,148595
Saint Lucia,LCA,1994,43610,106951,150561
Saint Lucia,LCA,1995,43823,108525,152348
Saint Lucia,LCA,1996,43981,109988,153969
Saint Lucia,LCA,1997,44096,111358,155454
Saint Lucia,LCA,1998,44183,112672,156855
Saint Lucia,LCA,1999,44266,113990,158256
Saint Lucia,LCA,2000,44300,115200,159500
Saint Lucia,LCA,2001,44120,116474,160594
Saint Lucia,LCA,2002,42600,119199,161799
Saint Lucia,LCA,2003,41114,121933,163047
Saint Lucia,LCA,2004,39636,124603,164239
Saint Lucia,LCA,2005,38179,127207,165386
Saint Lucia,LCA,2006,36737,129733,166470
Saint Lucia,LCA,2007,35319,132199,167518
Saint Lucia,LCA,2008,33936,134640,168576
Saint Lucia,LCA,2009,32602,137086,169688
Saint Lucia,LCA,2010,31538,139397,170935
Saint Lucia,LCA,2011,31761,140384,172145
Saint Lucia,LCA,2012,31941,141183,173124
Saint Lucia,LCA,2013,32118,141860,173978
Saint Lucia,LCA,2014,32307,142497,174804
Saint Lucia,LCA,2015,32517,143106,175623
Saint Lucia,LCA,2016,32739,143674,176413
Saint Lucia,LCA,2017,32974,144189,177163
Saint Lucia,LCA,2018,33226,144662,177888
Saint Lucia,LCA,2019,33491,145092,178583
Saint Lucia,LCA,2020,33770,145467,179237
Saint Lucia,LCA,2021,34026,145625,179651
Saint Vincent and the Grenadines,VCT,1960,21829,62312,84141
Saint Vincent and the Grenadines,VCT,1961,22611,63055,85666
Saint Vincent and the Grenadines,VCT,1962,23410,63773,87183
Saint Vincent and the Grenadines,VCT,1963,24211,64427,88638
Saint Vincent and the Grenadines,VCT,1964,25018,65035,90053
Saint Vincent and the Grenadines,VCT,1965,25849,65646,91495
Saint Vincent and the Grenadines,VCT,1966,26706,66251,92957
Saint Vincent and the Grenadines,VCT,1967,27569,66813,94382
Saint Vincent and the Grenadines,VCT,1968,28437,67321,95758
Saint Vincent and the Grenadines,VCT,1969,29319,67807,97126
Saint Vincent and the Grenadines,VCT,1970,30210,68249,98459
Saint Vincent and the Grenadines,VCT,1971,31088,68611,99699
Saint Vincent and the Grenadines,VCT,1972,31954,68889,100843
Saint Vincent and the Grenadines,VCT,1973,32814,69110,101924
Saint Vincent and the Grenadines,VCT,1974,33673,69278,102951
Saint Vincent and the Grenadines,VCT,1975,34514,69365,103879
Saint Vincent and the Grenadines,VCT,1976,35336,69373,104709
Saint Vincent and the Grenadines,VCT,1977,36156,69343,105499
Saint Vincent and the Grenadines,VCT,1978,36970,69266,106236
Saint Vincent and the Grenadines,VCT,1979,37765,69117,106882
Saint Vincent and the Grenadines,VCT,1980,38553,68927,107480
Saint Vincent and the Grenadines,VCT,1981,39391,68800,108191
Saint Vincent and the Grenadines,VCT,1982,40269,68705,108974
Saint Vincent and the Grenadines,VCT,1983,41132,68552,109684
Saint Vincent and the Grenadines,VCT,1984,41980,68349,110329
Saint Vincent and the Grenadines,VCT,1985,42812,68094,110906
Saint Vincent and the Grenadines,VCT,1986,43617,67771,111388
Saint Vincent and the Grenadines,VCT,1987,44392,67378,111770
Saint Vincent and the Grenadines,VCT,1988,45144,66932,112076
Saint Vincent and the Grenadines,VCT,1989,45875,66445,112320
Saint Vincent and the Grenadines,VCT,1990,46580,65907,112487
Saint Vincent and the Grenadines,VCT,1991,47310,65470,112780
Saint Vincent and the Grenadines,VCT,1992,47900,65322,113222
Saint Vincent and the Grenadines,VCT,1993,48474,65147,113621
Saint Vincent and the Grenadines,VCT,1994,49020,64924,113944
Saint Vincent and the Grenadines,VCT,1995,49529,64645,114174
Saint Vincent and the Grenadines,VCT,1996,49992,64298,114290
Saint Vincent and the Grenadines,VCT,1997,50396,63880,114276
Saint Vincent and the Grenadines,VCT,1998,50759,63406,114165
Saint Vincent and the Grenadines,VCT,1999,51096,62899,113995
Saint Vincent and the Grenadines,VCT,2000,51428,62385,113813
Saint Vincent and the Grenadines,VCT,2001,51761,61880,113641
Saint Vincent and the Grenadines,VCT,2002,52089,61361,113450
Saint Vincent and the Grenadines,VCT,2003,52350,60758,113108
Saint Vincent and the Grenadines,VCT,2004,52538,60070,112608
Saint Vincent and the Grenadines,VCT,2005,52696,59347,112043
Saint Vincent and the Grenadines,VCT,2006,52830,58597,111427
Saint Vincent and the Grenadines,VCT,2007,52967,57857,110824
Saint Vincent and the Grenadines,VCT,2008,53150,57166,110316
Saint Vincent and the Grenadines,VCT,2009,53348,56492,109840
Saint Vincent and the Grenadines,VCT,2010,53518,55790,109308
Saint Vincent and the Grenadines,VCT,2011,53651,55052,108703
Saint Vincent and the Grenadines,VCT,2012,53776,54307,108083
Saint Vincent and the Grenadines,VCT,2013,53890,53560,107450
Saint Vincent and the Grenadines,VCT,2014,54053,52859,106912
Saint Vincent and the Grenadines,VCT,2015,54267,52215,106482
Saint Vincent and the Grenadines,VCT,2016,54436,51527,105963
Saint Vincent and the Grenadines,VCT,2017,54657,50892,105549
Saint Vincent and the Grenadines,VCT,2018,54955,50326,105281
Saint Vincent and the Grenadines,VCT,2019,55205,49719,104924
Saint Vincent and the Grenadines,VCT,2020,55488,49144,104632
Saint Vincent and the Grenadines,VCT,2021,55768,48564,104332
Samoa,WSM,1960,21450,91885,113335
Samoa,WSM,1961,22179,94641,116820
Samoa,WSM,1962,22904,97259,120163
Samoa,WSM,1963,23623,99793,123416
Samoa,WSM,1964,24330,102252,126582
Samoa,WSM,1965,25051,104738,129789
Samoa,WSM,1966,25773,107203,132976
Samoa,WSM,1967,26598,109154,135752
Samoa,WSM,1968,27415,110739,138154
Samoa,WSM,1969,28228,112229,140457
Samoa,WSM,1970,29058,113713,142771
Samoa,WSM,1971,29899,115165,145064
Samoa,WSM,1972,30574,116758,147332
Samoa,WSM,1973,31162,118425,149587
Samoa,WSM,1974,31836,120404,152240
Samoa,WSM,1975,32593,122670,155263
Samoa,WSM,1976,33324,124812,158136
Samoa,WSM,1977,33857,126505,160362
Samoa,WSM,1978,34233,127755,161988
Samoa,WSM,1979,34583,128906,163489
Samoa,WSM,1980,34915,129990,164905
Samoa,WSM,1981,35221,130969,166190
Samoa,WSM,1982,35380,131505,166885
Samoa,WSM,1983,35392,131552,166944
Samoa,WSM,1984,35357,131422,166779
Samoa,WSM,1985,35302,131215,166517
Samoa,WSM,1986,35269,131096,166365
Samoa,WSM,1987,35356,131417,166773
Samoa,WSM,1988,35500,131952,167452
Samoa,WSM,1989,35592,132294,167886
Samoa,WSM,1990,35655,132531,168186
Samoa,WSM,1991,35765,132936,168701
Samoa,WSM,1992,36096,133703,169799
Samoa,WSM,1993,36581,134781,171362
Samoa,WSM,1994,37107,136000,173107
Samoa,WSM,1995,37649,137253,174902
Samoa,WSM,1996,38198,138515,176713
Samoa,WSM,1997,38753,139790,178543
Samoa,WSM,1998,39317,141068,180385
Samoa,WSM,1999,39879,142332,182211
Samoa,WSM,2000,40439,143569,184008
Samoa,WSM,2001,40943,144587,185530
Samoa,WSM,2002,40948,145682,186630
Samoa,WSM,2003,40671,146769,187440
Samoa,WSM,2004,40355,147718,188073
Samoa,WSM,2005,40023,148603,188626
Samoa,WSM,2006,39734,149645,189379
Samoa,WSM,2007,39524,150954,190478
Samoa,WSM,2008,39362,152425,191787
Samoa,WSM,2009,39215,153961,193176
Samoa,WSM,2010,39086,155586,194672
Samoa,WSM,2011,38989,157362,196351
Samoa,WSM,2012,38880,159244,198124
Samoa,WSM,2013,38758,161181,199939
Samoa,WSM,2014,38634,163123,201757
Samoa,WSM,2015,38503,165068,203571
Samoa,WSM,2016,38398,167146,205544
Samoa,WSM,2017,38312,169318,207630
Samoa,WSM,2018,38256,171445,209701
Samoa,WSM,2019,38262,173643,211905
Samoa,WSM,2020,38449,176480,214929
Samoa,WSM,2021,38813,179951,218764
San Marino,SMR,1960,7607,7949,15556
San Marino,SMR,1961,7948,7947,15895
San Marino,SMR,1962,8300,7942,16242
San Marino,SMR,1963,8657,7926,16583
San Marino,SMR,1964,9023,7903,16926
San Marino,SMR,1965,9397,7876,17273
San Marino,SMR,1966,9760,7828,17588
San Marino,SMR,1967,10132,7775,17907
San Marino,SMR,1968,10547,7744,18291
San Marino,SMR,1969,10809,7594,18403
San Marino,SMR,1970,10865,7304,18169
San Marino,SMR,1971,11343,6869,18212
San Marino,SMR,1972,12019,6556,18575
San Marino,SMR,1973,12745,6265,19010
San Marino,SMR,1974,13473,5966,19439
San Marino,SMR,1975,14156,5647,19803
San Marino,SMR,1976,14831,5329,20160
San Marino,SMR,1977,15487,4995,20482
San Marino,SMR,1978,16138,4657,20795
San Marino,SMR,1979,16759,4328,21087
San Marino,SMR,1980,17340,4006,21346
San Marino,SMR,1981,17895,3701,21596
San Marino,SMR,1982,18399,3405,21804
San Marino,SMR,1983,18851,3122,21973
San Marino,SMR,1984,19245,2851,22096
San Marino,SMR,1985,19637,2604,22241
San Marino,SMR,1986,20015,2375,22390
San Marino,SMR,1987,20283,2154,22437
San Marino,SMR,1988,20378,2164,22542
San Marino,SMR,1989,20614,2189,22803
San Marino,SMR,1990,20911,2221,23132
San Marino,SMR,1991,21207,2252,23459
San Marino,SMR,1992,21522,2286,23808
San Marino,SMR,1993,21966,2215,24181
San Marino,SMR,1994,22391,2144,24535
San Marino,SMR,1995,22812,2074,24886
San Marino,SMR,1996,23229,2006,25235
San Marino,SMR,1997,23656,1940,25596
San Marino,SMR,1998,24119,1878,25997
San Marino,SMR,1999,24586,1818,26404
San Marino,SMR,2000,25063,1760,26823
San Marino,SMR,2001,25627,1708,27335
San Marino,SMR,2002,26270,1699,27969
San Marino,SMR,2003,26878,1723,28601
San Marino,SMR,2004,27393,1700,29093
San Marino,SMR,2005,27871,1637,29508
San Marino,SMR,2006,28382,1577,29959
San Marino,SMR,2007,28856,1516,30372
San Marino,SMR,2008,29246,1454,30700
San Marino,SMR,2009,29664,1395,31059
San Marino,SMR,2010,30261,1347,31608
San Marino,SMR,2011,31183,1312,32495
San Marino,SMR,2012,31863,1269,33132
San Marino,SMR,2013,32077,1208,33285
San Marino,SMR,2014,32240,1149,33389
San Marino,SMR,2015,32475,1095,33570
San Marino,SMR,2016,32789,1045,33834
San Marino,SMR,2017,33059,997,34056
San Marino,SMR,2018,33209,947,34156
San Marino,SMR,2019,33278,900,34178
San Marino,SMR,2020,33156,851,34007
San Marino,SMR,2021,32942,803,33745
Sao Tome and Principe,STP,1960,10936,57102,68038
Sao Tome and Principe,STP,1961,11546,57159,68705
Sao Tome and Principe,STP,1962,12492,57028,69520
Sao Tome and Principe,STP,1963,13488,56784,70272
Sao Tome and Principe,STP,1964,14542,56450,70992
Sao Tome and Principe,STP,1965,15661,56069,71730
Sao Tome and Principe,STP,1966,16870,55697,72567
Sao Tome and Principe,STP,1967,18188,55376,73564
Sao Tome and Principe,STP,1968,19629,55110,74739
Sao Tome and Principe,STP,1969,21191,54868,76059
Sao Tome and Principe,STP,1970,22901,54682,77583
Sao Tome and Principe,STP,1971,23930,55296,79226
Sao Tome and Principe,STP,1972,24704,56131,80835
Sao Tome and Principe,STP,1973,25498,56974,82472
Sao Tome and Principe,STP,1974,26332,57857,84189
Sao Tome and Principe,STP,1975,27221,58816,86037
Sao Tome and Principe,STP,1976,28188,59890,88078
Sao Tome and Principe,STP,1977,29230,61069,90299
Sao Tome and Principe,STP,1978,30335,62324,92659
Sao Tome and Principe,STP,1979,31459,63558,95017
Sao Tome and Principe,STP,1980,32548,64662,97210
Sao Tome and Principe,STP,1981,33576,65594,99170
Sao Tome and Principe,STP,1982,35150,65781,100931
Sao Tome and Principe,STP,1983,36838,65812,102650
Sao Tome and Principe,STP,1984,38625,65872,104497
Sao Tome and Principe,STP,1985,40563,66044,106607
Sao Tome and Principe,STP,1986,42659,66307,108966
Sao Tome and Principe,STP,1987,44934,66676,111610
Sao Tome and Principe,STP,1988,47388,67125,114513
Sao Tome and Principe,STP,1989,49927,67518,117445
Sao Tome and Principe,STP,1990,52527,67816,120343
Sao Tome and Principe,STP,1991,55133,67951,123084
Sao Tome and Principe,STP,1992,57502,68146,125648
Sao Tome and Principe,STP,1993,59883,68299,128182
Sao Tome and Principe,STP,1994,62292,68374,130666
Sao Tome and Principe,STP,1995,64717,68360,133077
Sao Tome and Principe,STP,1996,67154,68258,135412
Sao Tome and Principe,STP,1997,69585,68071,137656
Sao Tome and Principe,STP,1998,72004,67786,139790
Sao Tome and Principe,STP,1999,74402,67406,141808
Sao Tome and Principe,STP,2000,76778,66936,143714
Sao Tome and Principe,STP,2001,79531,66727,146258
Sao Tome and Principe,STP,2002,83244,66597,149841
Sao Tome and Principe,STP,2003,87285,66477,153762
Sao Tome and Principe,STP,2004,91420,66277,157697
Sao Tome and Principe,STP,2005,95658,66022,161680
Sao Tome and Principe,STP,2006,100012,65713,165725
Sao Tome and Principe,STP,2007,104489,65356,169845
Sao Tome and Principe,STP,2008,109066,64938,174004
Sao Tome and Principe,STP,2009,113687,64441,178128
Sao Tome and Principe,STP,2010,118302,63836,182138
Sao Tome and Principe,STP,2011,122908,63136,186044
Sao Tome and Principe,STP,2012,127553,62371,189924
Sao Tome and Principe,STP,2013,132158,61599,193757
Sao Tome and Principe,STP,2014,136694,60803,197497
Sao Tome and Principe,STP,2015,141137,59987,201124
Sao Tome and Principe,STP,2016,145477,59155,204632
Sao Tome and Principe,STP,2017,149719,58317,208036
Sao Tome and Principe,STP,2018,153865,57479,211344
Sao Tome and Principe,STP,2019,157941,56658,214599
Sao Tome and Principe,STP,2020,162568,56073,218641
Sao Tome and Principe,STP,2021,167493,55614,223107
Saudi Arabia,SAU,1960,1301738,2863825,4165563
Saudi Arabia,SAU,1961,1393997,2912051,4306048
Saudi Arabia,SAU,1962,1494405,2964111,4458516
Saudi Arabia,SAU,1963,1618088,3003567,4621655
Saudi Arabia,SAU,1964,1768060,3027070,4795130
Saudi Arabia,SAU,1965,1930278,3048644,4978922
Saudi Arabia,SAU,1966,2105611,3067626,5173237
Saudi Arabia,SAU,1967,2295815,3085211,5381026
Saudi Arabia,SAU,1968,2502670,3101912,5604582
Saudi Arabia,SAU,1969,2726912,3117931,5844843
Saudi Arabia,SAU,1970,2971822,3134369,6106191
Saudi Arabia,SAU,1971,3242338,3154320,6396658
Saudi Arabia,SAU,1972,3544156,3180104,6724260
Saudi Arabia,SAU,1973,3878401,3210357,7088758
Saudi Arabia,SAU,1974,4243447,3240059,7483506
Saudi Arabia,SAU,1975,4608138,3289406,7897544
Saudi Arabia,SAU,1976,4983164,3336392,8319556
Saudi Arabia,SAU,1977,5377543,3377676,8755219
Saudi Arabia,SAU,1978,5795747,3414817,9210564
Saudi Arabia,SAU,1979,6235693,3446309,9682002
Saudi Arabia,SAU,1980,6699088,3472622,10171710
Saudi Arabia,SAU,1981,7184407,3493804,10678211
Saudi Arabia,SAU,1982,7692168,3508986,11201154
Saudi Arabia,SAU,1983,8226090,3519930,11746020
Saudi Arabia,SAU,1984,8784674,3525687,12310361
Saudi Arabia,SAU,1985,9364376,3525869,12890245
Saudi Arabia,SAU,1986,9964195,3519154,13483349
Saudi Arabia,SAU,1987,10509439,3580359,14089798
Saudi Arabia,SAU,1988,11074572,3639143,14713715
Saudi Arabia,SAU,1989,11657705,3695522,15353227
Saudi Arabia,SAU,1990,12256928,3747835,16004763
Saudi Arabia,SAU,1991,12860932,3793344,16654276
Saudi Arabia,SAU,1992,13453704,3827646,17281350
Saudi Arabia,SAU,1993,13953434,3893027,17846461
Saudi Arabia,SAU,1994,14405469,3962059,18367528
Saudi Arabia,SAU,1995,14859864,4028993,18888857
Saudi Arabia,SAU,1996,15316652,4093628,19410280
Saudi Arabia,SAU,1997,15780627,4157750,19938377
Saudi Arabia,SAU,1998,16251748,4220832,20472580
Saudi Arabia,SAU,1999,16727051,4282609,21009660
Saudi Arabia,SAU,2000,17205160,4342230,21547390
Saudi Arabia,SAU,2001,17685749,4400180,22085929
Saudi Arabia,SAU,2002,18167507,4455908,22623415
Saudi Arabia,SAU,2003,18643377,4507470,23150847
Saudi Arabia,SAU,2004,19107856,4553952,23661808
Saudi Arabia,SAU,2005,19756968,4640676,24397644
Saudi Arabia,SAU,2006,20611906,4770964,25382870
Saudi Arabia,SAU,2007,21496783,4903285,26400068
Saudi Arabia,SAU,2008,22402324,5035029,27437353
Saudi Arabia,SAU,2009,23318830,5164967,28483797
Saudi Arabia,SAU,2010,24142488,5269441,29411929
Saudi Arabia,SAU,2011,24814831,5336114,30150945
Saudi Arabia,SAU,2012,25433937,5387606,30821543
Saudi Arabia,SAU,2013,26048619,5433879,31482498
Saudi Arabia,SAU,2014,26651368,5474196,32125564
Saudi Arabia,SAU,2015,27241324,5508524,32749848
Saudi Arabia,SAU,2016,27869503,5546767,33416270
Saudi Arabia,SAU,2017,28592972,5600150,34193122
Saudi Arabia,SAU,2018,29360603,5657530,35018133
Saudi Arabia,SAU,2019,30118272,5709090,35827362
Saudi Arabia,SAU,2020,30340882,5656225,35997107
Saudi Arabia,SAU,2021,30380961,5569435,35950396
Senegal,SEN,1960,752831,2520346,3273177
Senegal,SEN,1961,796147,2570935,3367082
Senegal,SEN,1962,841740,2621784,3463524
Senegal,SEN,1963,889655,2672814,3562469
Senegal,SEN,1964,940226,2724373,3664599
Senegal,SEN,1965,993663,2777211,3770874
Senegal,SEN,1966,1050351,2831643,3881994
Senegal,SEN,1967,1110448,2887421,3997869
Senegal,SEN,1968,1173821,2943838,4117659
Senegal,SEN,1969,1240324,3000535,4240859
Senegal,SEN,1970,1310323,3057421,4367744
Senegal,SEN,1971,1381975,3116641,4498616
Senegal,SEN,1972,1457267,3176185,4633452
Senegal,SEN,1973,1536072,3235967,4772039
Senegal,SEN,1974,1617675,3293746,4911421
Senegal,SEN,1975,1700796,3347126,5047922
Senegal,SEN,1976,1780880,3400315,5181195
Senegal,SEN,1977,1842935,3465362,5308297
Senegal,SEN,1978,1905269,3527956,5433225
Senegal,SEN,1979,1970770,3593704,5564474
Senegal,SEN,1980,2040217,3663652,5703869
Senegal,SEN,1981,2113870,3738159,5852029
Senegal,SEN,1982,2191621,3816771,6008392
Senegal,SEN,1983,2273225,3898649,6171874
Senegal,SEN,1984,2358579,3983222,6341801
Senegal,SEN,1985,2448460,4072245,6520705
Senegal,SEN,1986,2544029,4166856,6710885
Senegal,SEN,1987,2644464,4265373,6909837
Senegal,SEN,1988,2746788,4366848,7113636
Senegal,SEN,1989,2837576,4484256,7321832
Senegal,SEN,1990,2931203,4604798,7536001
Senegal,SEN,1991,3027119,4727170,7754289
Senegal,SEN,1992,3124415,4850099,7974514
Senegal,SEN,1993,3222966,4973585,8196551
Senegal,SEN,1994,3321684,5095313,8416997
Senegal,SEN,1995,3419060,5213621,8632681
Senegal,SEN,1996,3515172,5328251,8843423
Senegal,SEN,1997,3610749,5440790,9051539
Senegal,SEN,1998,3707759,5553767,9261526
Senegal,SEN,1999,3808203,5670361,9478564
Senegal,SEN,2000,3912769,5791518,9704287
Senegal,SEN,2001,4021323,5916704,9938027
Senegal,SEN,2002,4134178,6046772,10180950
Senegal,SEN,2003,4267503,6167001,10434504
Senegal,SEN,2004,4419201,6279490,10698691
Senegal,SEN,2005,4577718,6396339,10974057
Senegal,SEN,2006,4744589,6518798,11263387
Senegal,SEN,2007,4918692,6645177,11563869
Senegal,SEN,2008,5099067,6773862,11872929
Senegal,SEN,2009,5287643,6907386,12195029
Senegal,SEN,2010,5484810,7045311,12530121
Senegal,SEN,2011,5689594,7186286,12875880
Senegal,SEN,2012,5901794,7330039,13231833
Senegal,SEN,2013,6120588,7474978,13595566
Senegal,SEN,2014,6347549,7622759,13970308
Senegal,SEN,2015,6584032,7772149,14356181
Senegal,SEN,2016,6829288,7922068,14751356
Senegal,SEN,2017,7084752,8073041,15157793
Senegal,SEN,2018,7350111,8224798,15574909
Senegal,SEN,2019,7624852,8375929,16000781
Senegal,SEN,2020,7909390,8526730,16436120
Senegal,SEN,2021,8202086,8674634,16876720
Serbia,SRB,1960,1920549,4687451,6608000
Serbia,SRB,1961,1999961,4655039,6655000
Serbia,SRB,1962,2079912,4616088,6696000
Serbia,SRB,1963,2160366,4571634,6732000
Serbia,SRB,1964,2241921,4523079,6765000
Serbia,SRB,1965,2323684,4470316,6794000
Serbia,SRB,1966,2413642,4427358,6841000
Serbia,SRB,1967,2502738,4377262,6880000
Serbia,SRB,1968,2592295,4322705,6915000
Serbia,SRB,1969,2681395,4263605,6945000
Serbia,SRB,1970,2770952,4201048,6972000
Serbia,SRB,1971,2857727,4155273,7013000
Serbia,SRB,1972,2915781,4137219,7053000
Serbia,SRB,1973,2973469,4117531,7091000
Serbia,SRB,1974,3031538,4096462,7128000
Serbia,SRB,1975,3089259,4073741,7163000
Serbia,SRB,1976,3154610,4059390,7214000
Serbia,SRB,1977,3217471,4040529,7258000
Serbia,SRB,1978,3278834,4018166,7297000
Serbia,SRB,1979,3338919,3993081,7332000
Serbia,SRB,1980,3397269,3964731,7362000
Serbia,SRB,1981,3458357,3946643,7405000
Serbia,SRB,1982,3505133,3934867,7440000
Serbia,SRB,1983,3548868,3919132,7468000
Serbia,SRB,1984,3589627,3899373,7489000
Serbia,SRB,1985,3627509,3876491,7504000
Serbia,SRB,1986,3673875,3862125,7536000
Serbia,SRB,1987,3715588,3842412,7558000
Serbia,SRB,1988,3753668,3818332,7572000
Serbia,SRB,1989,3789135,3791865,7581000
Serbia,SRB,1990,3822813,3763187,7586000
Serbia,SRB,1991,3855241,3740395,7595636
Serbia,SRB,1992,3898223,3748201,7646424
Serbia,SRB,1993,3942353,3756954,7699307
Serbia,SRB,1994,3977770,3756869,7734639
Serbia,SRB,1995,3938573,3686784,7625357
Serbia,SRB,1996,3951731,3666063,7617794
Serbia,SRB,1997,3957625,3638876,7596501
Serbia,SRB,1998,3959596,3608149,7567745
Serbia,SRB,1999,3962104,3578297,7540401
Serbia,SRB,2000,3966301,3550045,7516346
Serbia,SRB,2001,3976219,3527214,7503433
Serbia,SRB,2002,3989274,3507248,7496522
Serbia,SRB,2003,3997403,3483188,7480591
Serbia,SRB,2004,4004805,3458352,7463157
Serbia,SRB,2005,4009310,3431459,7440769
Serbia,SRB,2006,4010029,3401540,7411569
Serbia,SRB,2007,4010264,3371315,7381579
Serbia,SRB,2008,4009546,3340676,7350222
Serbia,SRB,2009,4009752,3311055,7320807
Serbia,SRB,2010,4009779,3281657,7291436
Serbia,SRB,2011,3994308,3239791,7234099
Serbia,SRB,2012,3985121,3213956,7199077
Serbia,SRB,2013,3973872,3190260,7164132
Serbia,SRB,2014,3963388,3167188,7130576
Serbia,SRB,2015,3951845,3143538,7095383
Serbia,SRB,2016,3939250,3119072,7058322
Serbia,SRB,2017,3927608,3093250,7020858
Serbia,SRB,2018,3916682,3065922,6982604
Serbia,SRB,2019,3907389,3037846,6945235
Serbia,SRB,2020,3894281,3004845,6899126
Serbia,SRB,2021,3871714,2962612,6834326
Seychelles,SYC,1960,11540,30160,41700
Seychelles,SYC,1961,12316,30573,42889
Seychelles,SYC,1962,13118,30924,44042
Seychelles,SYC,1963,13949,31227,45176
Seychelles,SYC,1964,14819,31503,46322
Seychelles,SYC,1965,15733,31767,47500
Seychelles,SYC,1966,16693,32006,48699
Seychelles,SYC,1967,17693,32218,49911
Seychelles,SYC,1968,18736,32398,51134
Seychelles,SYC,1969,19818,32547,52365
Seychelles,SYC,1970,20940,32660,53600
Seychelles,SYC,1971,22062,32633,54695
Seychelles,SYC,1972,23421,32608,56029
Seychelles,SYC,1973,24621,32271,56892
Seychelles,SYC,1974,25937,32000,57937
Seychelles,SYC,1975,27432,31860,59292
Seychelles,SYC,1976,28905,31599,60504
Seychelles,SYC,1977,30449,31337,61786
Seychelles,SYC,1978,30700,31450,62150
Seychelles,SYC,1979,30955,31731,62686
Seychelles,SYC,1980,31229,32032,63261
Seychelles,SYC,1981,31603,32432,64035
Seychelles,SYC,1982,31779,32634,64413
Seychelles,SYC,1983,31731,32604,64335
Seychelles,SYC,1984,31910,32807,64717
Seychelles,SYC,1985,32160,33084,65244
Seychelles,SYC,1986,32351,33301,65652
Seychelles,SYC,1987,33744,34755,68499
Seychelles,SYC,1988,33860,34895,68755
Seychelles,SYC,1989,34065,35102,69167
Seychelles,SYC,1990,34246,35261,69507
Seychelles,SYC,1991,34731,35708,70439
Seychelles,SYC,1992,34930,35833,70763
Seychelles,SYC,1993,35718,36535,72253
Seychelles,SYC,1994,36750,37455,74205
Seychelles,SYC,1995,37376,37928,75304
Seychelles,SYC,1996,38024,38393,76417
Seychelles,SYC,1997,38583,38736,77319
Seychelles,SYC,1998,39471,39375,78846
Seychelles,SYC,1999,40396,40014,80410
Seychelles,SYC,2000,40917,40214,81131
Seychelles,SYC,2001,41126,40076,81202
Seychelles,SYC,2002,42595,41128,83723
Seychelles,SYC,2003,42320,40461,82781
Seychelles,SYC,2004,42382,40093,82475
Seychelles,SYC,2005,42813,40045,82858
Seychelles,SYC,2006,43966,40634,84600
Seychelles,SYC,2007,44460,40573,85033
Seychelles,SYC,2008,45755,41201,86956
Seychelles,SYC,2009,46241,41057,87298
Seychelles,SYC,2010,47880,41890,89770
Seychelles,SYC,2011,46973,40468,87441
Seychelles,SYC,2012,47790,40513,88303
Seychelles,SYC,2013,49055,40894,89949
Seychelles,SYC,2014,50219,41140,91359
Seychelles,SYC,2015,51754,41665,93419
Seychelles,SYC,2016,52859,41818,94677
Seychelles,SYC,2017,53922,41921,95843
Seychelles,SYC,2018,54855,41907,96762
Seychelles,SYC,2019,55762,41863,97625
Seychelles,SYC,2020,56661,41801,98462
Seychelles,SYC,2021,57542,41716,99258
Sierra Leone,SLE,1960,399323,1901987,2301310
Sierra Leone,SLE,1961,419121,1921944,2341065
Sierra Leone,SLE,1962,440053,1942861,2382914
Sierra Leone,SLE,1963,462539,1964211,2426750
Sierra Leone,SLE,1964,487416,1985270,2472686
Sierra Leone,SLE,1965,513668,2006908,2520576
Sierra Leone,SLE,1966,541289,2028447,2569736
Sierra Leone,SLE,1967,570329,2050067,2620396
Sierra Leone,SLE,1968,600856,2071514,2672370
Sierra Leone,SLE,1969,632668,2092233,2724901
Sierra Leone,SLE,1970,665992,2112565,2778557
Sierra Leone,SLE,1971,700649,2131743,2832392
Sierra Leone,SLE,1972,736729,2149913,2886642
Sierra Leone,SLE,1973,774451,2167882,2942333
Sierra Leone,SLE,1974,813796,2185047,2998843
Sierra Leone,SLE,1975,847375,2208541,3055916
Sierra Leone,SLE,1976,875960,2236903,3112863
Sierra Leone,SLE,1977,905789,2266406,3172195
Sierra Leone,SLE,1978,937293,2297877,3235170
Sierra Leone,SLE,1979,970011,2330021,3300032
Sierra Leone,SLE,1980,1004148,2363329,3367477
Sierra Leone,SLE,1981,1039656,2397452,3437108
Sierra Leone,SLE,1982,1076622,2432575,3509197
Sierra Leone,SLE,1983,1115713,2470060,3585773
Sierra Leone,SLE,1984,1156889,2509373,3666262
Sierra Leone,SLE,1985,1199702,2549717,3749419
Sierra Leone,SLE,1986,1242223,2600694,3842917
Sierra Leone,SLE,1987,1285227,2662638,3947865
Sierra Leone,SLE,1988,1329911,2726304,4056215
Sierra Leone,SLE,1989,1373314,2785849,4159163
Sierra Leone,SLE,1990,1438278,2887110,4325388
Sierra Leone,SLE,1991,1466030,2912139,4378169
Sierra Leone,SLE,1992,1450488,2851078,4301566
Sierra Leone,SLE,1993,1458601,2837088,4295689
Sierra Leone,SLE,1994,1475369,2839584,4314953
Sierra Leone,SLE,1995,1488761,2835388,4324149
Sierra Leone,SLE,1996,1507103,2840267,4347370
Sierra Leone,SLE,1997,1537575,2867453,4405028
Sierra Leone,SLE,1998,1563899,2886076,4449975
Sierra Leone,SLE,1999,1583485,2891660,4475145
Sierra Leone,SLE,2000,1633120,2950947,4584067
Sierra Leone,SLE,2001,1742095,3115001,4857096
Sierra Leone,SLE,2002,1856043,3284070,5140113
Sierra Leone,SLE,2003,1945162,3405745,5350907
Sierra Leone,SLE,2004,2024977,3508352,5533329
Sierra Leone,SLE,2005,2098230,3585104,5683334
Sierra Leone,SLE,2006,2167220,3642554,5809774
Sierra Leone,SLE,2007,2238411,3700752,5939163
Sierra Leone,SLE,2008,2319217,3771643,6090860
Sierra Leone,SLE,2009,2407911,3851931,6259842
Sierra Leone,SLE,2010,2501043,3935655,6436698
Sierra Leone,SLE,2011,2595229,4017156,6612385
Sierra Leone,SLE,2012,2691132,4097455,6788587
Sierra Leone,SLE,2013,2788451,4176408,6964859
Sierra Leone,SLE,2014,2887123,4253565,7140688
Sierra Leone,SLE,2015,2986549,4328224,7314773
Sierra Leone,SLE,2016,3089590,4404323,7493913
Sierra Leone,SLE,2017,3196631,4480934,7677565
Sierra Leone,SLE,2018,3306062,4555219,7861281
Sierra Leone,SLE,2019,3418614,4628214,8046828
Sierra Leone,SLE,2020,3534267,4699703,8233970
Sierra Leone,SLE,2021,3652200,4768441,8420641
Singapore,SGP,1960,1646400,0,1646400
Singapore,SGP,1961,1702400,0,1702400
Singapore,SGP,1962,1750200,0,1750200
Singapore,SGP,1963,1795000,0,1795000
Singapore,SGP,1964,1841600,0,1841600
Singapore,SGP,1965,1886900,0,1886900
Singapore,SGP,1966,1934400,0,1934400
Singapore,SGP,1967,1977600,0,1977600
Singapore,SGP,1968,2012000,0,2012000
Singapore,SGP,1969,2042500,0,2042500
Singapore,SGP,1970,2074507,0,2074507
Singapore,SGP,1971,2112900,0,2112900
Singapore,SGP,1972,2152400,0,2152400
Singapore,SGP,1973,2193000,0,2193000
Singapore,SGP,1974,2229800,0,2229800
Singapore,SGP,1975,2262600,0,2262600
Singapore,SGP,1976,2293300,0,2293300
Singapore,SGP,1977,2325300,0,2325300
Singapore,SGP,1978,2353600,0,2353600
Singapore,SGP,1979,2383500,0,2383500
Singapore,SGP,1980,2413945,0,2413945
Singapore,SGP,1981,2532835,0,2532835
Singapore,SGP,1982,2646466,0,2646466
Singapore,SGP,1983,2681061,0,2681061
Singapore,SGP,1984,2732221,0,2732221
Singapore,SGP,1985,2735957,0,2735957
Singapore,SGP,1986,2733373,0,2733373
Singapore,SGP,1987,2774789,0,2774789
Singapore,SGP,1988,2846108,0,2846108
Singapore,SGP,1989,2930901,0,2930901
Singapore,SGP,1990,3047132,0,3047132
Singapore,SGP,1991,3135083,0,3135083
Singapore,SGP,1992,3230698,0,3230698
Singapore,SGP,1993,3313471,0,3313471
Singapore,SGP,1994,3419048,0,3419048
Singapore,SGP,1995,3524506,0,3524506
Singapore,SGP,1996,3670704,0,3670704
Singapore,SGP,1997,3796038,0,3796038
Singapore,SGP,1998,3927213,0,3927213
Singapore,SGP,1999,3958723,0,3958723
Singapore,SGP,2000,4027887,0,4027887
Singapore,SGP,2001,4138012,0,4138012
Singapore,SGP,2002,4175950,0,4175950
Singapore,SGP,2003,4114826,0,4114826
Singapore,SGP,2004,4166664,0,4166664
Singapore,SGP,2005,4265762,0,4265762
Singapore,SGP,2006,4401365,0,4401365
Singapore,SGP,2007,4588599,0,4588599
Singapore,SGP,2008,4839396,0,4839396
Singapore,SGP,2009,4987573,0,4987573
Singapore,SGP,2010,5076732,0,5076732
Singapore,SGP,2011,5183688,0,5183688
Singapore,SGP,2012,5312437,0,5312437
Singapore,SGP,2013,5399162,0,5399162
Singapore,SGP,2014,5469724,0,5469724
Singapore,SGP,2015,5535002,0,5535002
Singapore,SGP,2016,5607283,0,5607283
Singapore,SGP,2017,5612253,0,5612253
Singapore,SGP,2018,5638676,0,5638676
Singapore,SGP,2019,5703569,0,5703569
Singapore,SGP,2020,5685807,0,5685807
Singapore,SGP,2021,5453566,0,5453566
Sint Maarten (Dutch part),SXM,1960,2646,0,2646
Sint Maarten (Dutch part),SXM,1961,2888,0,2888
Sint Maarten (Dutch part),SXM,1962,3171,0,3171
Sint Maarten (Dutch part),SXM,1963,3481,0,3481
Sint Maarten (Dutch part),SXM,1964,3811,0,3811
Sint Maarten (Dutch part),SXM,1965,4161,0,4161
Sint Maarten (Dutch part),SXM,1966,4531,0,4531
Sint Maarten (Dutch part),SXM,1967,4930,0,4930
Sint Maarten (Dutch part),SXM,1968,5354,0,5354
Sint Maarten (Dutch part),SXM,1969,5795,0,5795
Sint Maarten (Dutch part),SXM,1970,6260,0,6260
Sint Maarten (Dutch part),SXM,1971,6736,0,6736
Sint Maarten (Dutch part),SXM,1972,7226,0,7226
Sint Maarten (Dutch part),SXM,1973,7750,0,7750
Sint Maarten (Dutch part),SXM,1974,8312,0,8312
Sint Maarten (Dutch part),SXM,1975,8906,0,8906
Sint Maarten (Dutch part),SXM,1976,9523,0,9523
Sint Maarten (Dutch part),SXM,1977,10172,0,10172
Sint Maarten (Dutch part),SXM,1978,10850,0,10850
Sint Maarten (Dutch part),SXM,1979,11542,0,11542
Sint Maarten (Dutch part),SXM,1980,12243,0,12243
Sint Maarten (Dutch part),SXM,1981,13134,0,13134
Sint Maarten (Dutch part),SXM,1982,14418,0,14418
Sint Maarten (Dutch part),SXM,1983,15927,0,15927
Sint Maarten (Dutch part),SXM,1984,17474,0,17474
Sint Maarten (Dutch part),SXM,1985,19064,0,19064
Sint Maarten (Dutch part),SXM,1986,20703,0,20703
Sint Maarten (Dutch part),SXM,1987,22395,0,22395
Sint Maarten (Dutch part),SXM,1988,24139,0,24139
Sint Maarten (Dutch part),SXM,1989,25952,0,25952
Sint Maarten (Dutch part),SXM,1990,27845,0,27845
Sint Maarten (Dutch part),SXM,1991,29820,0,29820
Sint Maarten (Dutch part),SXM,1992,31345,0,31345
Sint Maarten (Dutch part),SXM,1993,31823,0,31823
Sint Maarten (Dutch part),SXM,1994,31735,0,31735
Sint Maarten (Dutch part),SXM,1995,31596,0,31596
Sint Maarten (Dutch part),SXM,1996,31410,0,31410
Sint Maarten (Dutch part),SXM,1997,31195,0,31195
Sint Maarten (Dutch part),SXM,1998,31240,0,31240
Sint Maarten (Dutch part),SXM,1999,31084,0,31084
Sint Maarten (Dutch part),SXM,2000,30519,0,30519
Sint Maarten (Dutch part),SXM,2001,30600,0,30600
Sint Maarten (Dutch part),SXM,2002,30777,0,30777
Sint Maarten (Dutch part),SXM,2003,31472,0,31472
Sint Maarten (Dutch part),SXM,2004,32488,0,32488
Sint Maarten (Dutch part),SXM,2005,33011,0,33011
Sint Maarten (Dutch part),SXM,2006,33441,0,33441
Sint Maarten (Dutch part),SXM,2007,33811,0,33811
Sint Maarten (Dutch part),SXM,2008,33964,0,33964
Sint Maarten (Dutch part),SXM,2009,34238,0,34238
Sint Maarten (Dutch part),SXM,2010,34056,0,34056
Sint Maarten (Dutch part),SXM,2011,33435,0,33435
Sint Maarten (Dutch part),SXM,2012,34640,0,34640
Sint Maarten (Dutch part),SXM,2013,36607,0,36607
Sint Maarten (Dutch part),SXM,2014,37685,0,37685
Sint Maarten (Dutch part),SXM,2015,38825,0,38825
Sint Maarten (Dutch part),SXM,2016,39969,0,39969
Sint Maarten (Dutch part),SXM,2017,40574,0,40574
Sint Maarten (Dutch part),SXM,2018,40895,0,40895
Sint Maarten (Dutch part),SXM,2019,41608,0,41608
Sint Maarten (Dutch part),SXM,2020,42310,0,42310
Sint Maarten (Dutch part),SXM,2021,42846,0,42846
Slovakia,SVK,1960,1361347,2706748,4068095
Slovakia,SVK,1961,1423197,2768470,4191667
Slovakia,SVK,1962,1471245,2766943,4238188
Slovakia,SVK,1963,1519388,2762629,4282017
Slovakia,SVK,1964,1569094,2758247,4327341
Slovakia,SVK,1965,1619143,2751840,4370983
Slovakia,SVK,1966,1669066,2742600,4411666
Slovakia,SVK,1967,1718790,2730577,4449367
Slovakia,SVK,1968,1768232,2715683,4483915
Slovakia,SVK,1969,1818423,2700184,4518607
Slovakia,SVK,1970,1863258,2674965,4538223
Slovakia,SVK,1971,1914539,2642910,4557449
Slovakia,SVK,1972,1979489,2617133,4596622
Slovakia,SVK,1973,2047898,2593547,4641445
Slovakia,SVK,1974,2119100,2570523,4689623
Slovakia,SVK,1975,2192168,2546937,4739105
Slovakia,SVK,1976,2266922,2522585,4789507
Slovakia,SVK,1977,2343045,2497456,4840501
Slovakia,SVK,1978,2419732,2470393,4890125
Slovakia,SVK,1979,2497145,2441828,4938973
Slovakia,SVK,1980,2571477,2408338,4979815
Slovakia,SVK,1981,2623925,2392180,5016105
Slovakia,SVK,1982,2667930,2387169,5055099
Slovakia,SVK,1983,2711169,2380802,5091971
Slovakia,SVK,1984,2753815,2373282,5127097
Slovakia,SVK,1985,2796439,2365329,5161768
Slovakia,SVK,1986,2837965,2355873,5193838
Slovakia,SVK,1987,2878046,2344794,5222840
Slovakia,SVK,1988,2917651,2332945,5250596
Slovakia,SVK,1989,2956110,2319832,5275942
Slovakia,SVK,1990,2993564,2305623,5299187
Slovakia,SVK,1991,3011210,2292084,5303294
Slovakia,SVK,1992,3008952,2296064,5305016
Slovakia,SVK,1993,3017265,2308040,5325305
Slovakia,SVK,1994,3025916,2320415,5346331
Slovakia,SVK,1995,3031513,2330486,5361999
Slovakia,SVK,1996,3034659,2338702,5373361
Slovakia,SVK,1997,3037037,2346254,5383291
Slovakia,SVK,1998,3037825,2352691,5390516
Slovakia,SVK,1999,3037635,2358385,5396020
Slovakia,SVK,2000,3030239,2358481,5388720
Slovakia,SVK,2001,3020933,2357934,5378867
Slovakia,SVK,2002,3011770,2365142,5376912
Slovakia,SVK,2003,3001728,2371646,5373374
Slovakia,SVK,2004,2993058,2379222,5372280
Slovakia,SVK,2005,2985293,2387514,5372807
Slovakia,SVK,2006,2977317,2395737,5373054
Slovakia,SVK,2007,2970070,2404552,5374622
Slovakia,SVK,2008,2964549,2414684,5379233
Slovakia,SVK,2009,2960369,2426037,5386406
Slovakia,SVK,2010,2948302,2443126,5391428
Slovakia,SVK,2011,2937801,2460583,5398384
Slovakia,SVK,2012,2935234,2472345,5407579
Slovakia,SVK,2013,2930811,2482582,5413393
Slovakia,SVK,2014,2926070,2492579,5418649
Slovakia,SVK,2015,2922832,2500969,5423801
Slovakia,SVK,2016,2922095,2508703,5430798
Slovakia,SVK,2017,2923642,2515590,5439232
Slovakia,SVK,2018,2926332,2520439,5446771
Slovakia,SVK,2019,2930459,2523688,5454147
Slovakia,SVK,2020,2934665,2524162,5458827
Slovakia,SVK,2021,2931708,2515539,5447247
Slovenia,SVN,1960,446954,1137766,1584720
Slovenia,SVN,1961,464004,1130127,1594131
Slovenia,SVN,1962,480036,1123613,1603649
Slovenia,SVN,1963,497639,1119332,1616971
Slovenia,SVN,1964,516254,1115860,1632114
Slovenia,SVN,1965,535928,1113232,1649160
Slovenia,SVN,1966,557347,1112558,1669905
Slovenia,SVN,1967,578934,1110594,1689528
Slovenia,SVN,1968,599472,1105074,1704546
Slovenia,SVN,1969,618383,1095491,1713874
Slovenia,SVN,1970,638279,1086612,1724891
Slovenia,SVN,1971,660081,1078254,1738335
Slovenia,SVN,1972,684387,1067846,1752233
Slovenia,SVN,1973,709382,1057315,1766697
Slovenia,SVN,1974,732814,1043318,1776132
Slovenia,SVN,1975,760012,1033569,1793581
Slovenia,SVN,1976,791790,1028459,1820249
Slovenia,SVN,1977,822198,1020179,1842377
Slovenia,SVN,1978,852339,1010209,1862548
Slovenia,SVN,1979,882958,999641,1882599
Slovenia,SVN,1980,913487,987828,1901315
Slovenia,SVN,1981,933075,973456,1906531
Slovenia,SVN,1982,938012,972322,1910334
Slovenia,SVN,1983,946993,975328,1922321
Slovenia,SVN,1984,954948,977206,1932154
Slovenia,SVN,1985,962743,978898,1941641
Slovenia,SVN,1986,977988,987976,1965964
Slovenia,SVN,1987,993038,996738,1989776
Slovenia,SVN,1988,998955,996241,1995196
Slovenia,SVN,1989,1002747,993604,1996351
Slovenia,SVN,1990,1006873,991288,1998161
Slovenia,SVN,1991,1010052,989377,1999429
Slovenia,SVN,1992,1009090,987408,1996498
Slovenia,SVN,1993,1007206,984540,1991746
Slovenia,SVN,1994,1006579,982864,1989443
Slovenia,SVN,1995,1007313,982559,1989872
Slovenia,SVN,1996,1007220,981408,1988628
Slovenia,SVN,1997,1006383,979573,1985956
Slovenia,SVN,1998,1004706,976923,1981629
Slovenia,SVN,1999,1005959,977086,1983045
Slovenia,SVN,2000,1009459,979466,1988925
Slovenia,SVN,2001,1011568,980492,1992060
Slovenia,SVN,2002,1014358,980172,1994530
Slovenia,SVN,2003,1019460,976273,1995733
Slovenia,SVN,2004,1024627,972385,1997012
Slovenia,SVN,2005,1030904,969570,2000474
Slovenia,SVN,2006,1038715,968153,2006868
Slovenia,SVN,2007,1049080,969042,2018122
Slovenia,SVN,2008,1055309,966007,2021316
Slovenia,SVN,2009,1069460,970209,2039669
Slovenia,SVN,2010,1078743,969840,2048583
Slovenia,SVN,2011,1085605,967238,2052843
Slovenia,SVN,2012,1092516,964643,2057159
Slovenia,SVN,2013,1098614,961339,2059953
Slovenia,SVN,2014,1104335,957645,2061980
Slovenia,SVN,2015,1109788,953743,2063531
Slovenia,SVN,2016,1115536,949506,2065042
Slovenia,SVN,2017,1121491,944897,2066388
Slovenia,SVN,2018,1131123,942771,2073894
Slovenia,SVN,2019,1144894,943491,2088385
Slovenia,SVN,2020,1158811,943608,2102419
Slovenia,SVN,2021,1168445,939634,2108079
Solomon Islands,SLB,1960,7697,125743,133440
Solomon Islands,SLB,1961,8259,128521,136780
Solomon Islands,SLB,1962,8865,131389,140254
Solomon Islands,SLB,1963,9518,134345,143863
Solomon Islands,SLB,1964,10220,137389,147609
Solomon Islands,SLB,1965,10976,140519,151495
Solomon Islands,SLB,1966,11786,143728,155514
Solomon Islands,SLB,1967,12658,147009,159667
Solomon Islands,SLB,1968,13597,150376,163973
Solomon Islands,SLB,1969,14600,153799,168399
Solomon Islands,SLB,1970,15412,157421,172833
Solomon Islands,SLB,1971,15879,161385,177264
Solomon Islands,SLB,1972,16367,165509,181876
Solomon Islands,SLB,1973,16890,169926,186816
Solomon Islands,SLB,1974,17453,174702,192155
Solomon Islands,SLB,1975,18054,179799,197853
Solomon Islands,SLB,1976,18920,185162,204082
Solomon Islands,SLB,1977,20214,190718,210932
Solomon Islands,SLB,1978,21610,196583,218193
Solomon Islands,SLB,1979,23109,202677,225786
Solomon Islands,SLB,1980,24713,208955,233668
Solomon Islands,SLB,1981,26424,215403,241827
Solomon Islands,SLB,1982,28248,222002,250250
Solomon Islands,SLB,1983,30190,228755,258945
Solomon Islands,SLB,1984,32259,235654,267913
Solomon Islands,SLB,1985,34459,242699,277158
Solomon Islands,SLB,1986,36781,249746,286527
Solomon Islands,SLB,1987,38787,257049,295836
Solomon Islands,SLB,1988,40576,264556,305132
Solomon Islands,SLB,1989,42422,272138,314560
Solomon Islands,SLB,1990,44337,279834,324171
Solomon Islands,SLB,1991,46319,287633,333952
Solomon Islands,SLB,1992,48372,295544,343916
Solomon Islands,SLB,1993,50500,303586,354086
Solomon Islands,SLB,1994,52715,311790,364505
Solomon Islands,SLB,1995,55018,320171,375189
Solomon Islands,SLB,1996,57405,328664,386069
Solomon Islands,SLB,1997,59859,337191,397050
Solomon Islands,SLB,1998,62385,345760,408145
Solomon Islands,SLB,1999,64964,354265,419229
Solomon Islands,SLB,2000,67992,361986,429978
Solomon Islands,SLB,2001,71348,369047,440395
Solomon Islands,SLB,2002,74813,375947,450760
Solomon Islands,SLB,2003,78411,382805,461216
Solomon Islands,SLB,2004,82152,389633,471785
Solomon Islands,SLB,2005,86037,396449,482486
Solomon Islands,SLB,2006,90095,403335,493430
Solomon Islands,SLB,2007,94333,410286,504619
Solomon Islands,SLB,2008,98752,417249,516001
Solomon Islands,SLB,2009,103397,424436,527833
Solomon Islands,SLB,2010,108338,432056,540394
Solomon Islands,SLB,2011,113557,440164,553721
Solomon Islands,SLB,2012,119060,448703,567763
Solomon Islands,SLB,2013,124818,457547,582365
Solomon Islands,SLB,2014,130801,466574,597375
Solomon Islands,SLB,2015,136991,475669,612660
Solomon Islands,SLB,2016,143352,484750,628102
Solomon Islands,SLB,2017,149877,493757,643634
Solomon Islands,SLB,2018,156565,502684,659249
Solomon Islands,SLB,2019,163416,511577,674993
Solomon Islands,SLB,2020,170517,520674,691191
Solomon Islands,SLB,2021,177869,529982,707851
Somalia,SOM,1960,496981,2373751,2870732
Somalia,SOM,1961,525359,2420303,2945662
Somalia,SOM,1962,555354,2467473,3022827
Somalia,SOM,1963,586931,2515239,3102170
Somalia,SOM,1964,619304,2564286,3183590
Somalia,SOM,1965,652342,2615251,3267593
Somalia,SOM,1966,687065,2666600,3353665
Somalia,SOM,1967,723466,2718333,3441799
Somalia,SOM,1968,761696,2770724,3532420
Somalia,SOM,1969,801729,2823545,3625274
Somalia,SOM,1970,843843,2877134,3720977
Somalia,SOM,1971,887814,2930575,3818389
Somalia,SOM,1972,933908,2984312,3918220
Somalia,SOM,1973,982536,3039800,4022336
Somalia,SOM,1974,1032693,3093130,4125823
Somalia,SOM,1975,1078129,3150160,4228289
Somalia,SOM,1976,1115861,3217918,4333779
Somalia,SOM,1977,1156827,3292678,4449505
Somalia,SOM,1978,1254243,3523460,4777703
Somalia,SOM,1979,1433714,3975099,5408813
Somalia,SOM,1980,1576936,4315288,5892224
Somalia,SOM,1981,1603680,4331258,5934938
Somalia,SOM,1982,1623652,4328153,5951805
Somalia,SOM,1983,1691710,4450803,6142513
Somalia,SOM,1984,1770842,4598178,6369020
Somalia,SOM,1985,1861021,4769616,6630637
Somalia,SOM,1986,1957408,4951171,6908579
Somalia,SOM,1987,2049122,5108882,7158004
Somalia,SOM,1988,2074314,5086147,7160461
Somalia,SOM,1989,2062210,4973168,7035378
Somalia,SOM,1990,2075792,4923304,6999096
Somalia,SOM,1991,2020282,4712420,6732702
Somalia,SOM,1992,1951519,4476622,6428141
Somalia,SOM,1993,2033292,4587437,6620729
Somalia,SOM,1994,2162210,4797618,6959828
Somalia,SOM,1995,2266035,4944895,7210930
Somalia,SOM,1996,2375118,5097332,7472450
Somalia,SOM,1997,2486350,5247963,7734313
Somalia,SOM,1998,2619366,5437496,8056862
Somalia,SOM,1999,2756649,5627830,8384479
Somalia,SOM,2000,2899625,5821840,8721465
Somalia,SOM,2001,3049313,6021434,9070747
Somalia,SOM,2002,3198834,6212269,9411103
Somalia,SOM,2003,3391588,6366693,9758281
Somalia,SOM,2004,3594797,6522557,10117354
Somalia,SOM,2005,3800778,6666514,10467292
Somalia,SOM,2006,4001225,6783748,10784973
Somalia,SOM,2007,3825068,7293024,11118092
Somalia,SOM,2008,4121412,7323458,11444870
Somalia,SOM,2009,4415772,7314265,11730037
Somalia,SOM,2010,4727676,7298973,12026649
Somalia,SOM,2011,5008903,7207934,12216837
Somalia,SOM,2012,5169951,7270375,12440326
Somalia,SOM,2013,5413081,7439404,12852485
Somalia,SOM,2014,5680248,7628987,13309235
Somalia,SOM,2015,5952201,7811705,13763906
Somalia,SOM,2016,6262554,8030293,14292847
Somalia,SOM,2017,6598376,8265845,14864221
Somalia,SOM,2018,6930523,8480571,15411094
Somalia,SOM,2019,7280121,8701179,15981300
Somalia,SOM,2020,7630345,8906671,16537016
Somalia,SOM,2021,7974917,9090664,17065581
South Africa,ZAF,1960,7701664,8818777,16520441
South Africa,ZAF,1961,7949880,9039584,16989464
South Africa,ZAF,1962,8210020,9293113,17503133
South Africa,ZAF,1963,8483449,9558766,18042215
South Africa,ZAF,1964,8768384,9834713,18603097
South Africa,ZAF,1965,9065565,10121629,19187194
South Africa,ZAF,1966,9372831,10416940,19789771
South Africa,ZAF,1967,9690173,10720504,20410677
South Africa,ZAF,1968,10017952,11032588,21050540
South Africa,ZAF,1969,10353778,11350436,21704214
South Africa,ZAF,1970,10694063,11674243,22368306
South Africa,ZAF,1971,11024920,12006521,23031441
South Africa,ZAF,1972,11358457,12340050,23698507
South Africa,ZAF,1973,11700924,12681589,24382513
South Africa,ZAF,1974,12049255,13027761,25077016
South Africa,ZAF,1975,12401521,13376443,25777964
South Africa,ZAF,1976,12755296,13725004,26480300
South Africa,ZAF,1977,13118210,14081628,27199838
South Africa,ZAF,1978,13493610,14449835,27943445
South Africa,ZAF,1979,13874719,14822295,28697014
South Africa,ZAF,1980,14267724,15195825,29463549
South Africa,ZAF,1981,14690304,15542257,30232561
South Africa,ZAF,1982,15125290,15897127,31022417
South Africa,ZAF,1983,15589081,16276095,31865176
South Africa,ZAF,1984,16085257,16682950,32768207
South Africa,ZAF,1985,16664513,17088452,33752965
South Africa,ZAF,1986,17405783,17472052,34877835
South Africa,ZAF,1987,18218230,17901104,36119334
South Africa,ZAF,1988,19060395,18333458,37393853
South Africa,ZAF,1989,19916306,18752378,38668684
South Africa,ZAF,1990,20751091,19126480,39877571
South Africa,ZAF,1991,21500345,19410614,40910959
South Africa,ZAF,1992,22149069,19611686,41760755
South Africa,ZAF,1993,22760041,19765400,42525441
South Africa,ZAF,1994,23366441,19901540,43267981
South Africa,ZAF,1995,23966258,20019826,43986084
South Africa,ZAF,1996,24549143,20112460,44661603
South Africa,ZAF,1997,25110106,20174942,45285048
South Africa,ZAF,1998,25645116,20207050,45852166
South Africa,ZAF,1999,26154780,20209900,46364680
South Africa,ZAF,2000,26632535,20180732,46813267
South Africa,ZAF,2001,27094742,20134972,47229714
South Africa,ZAF,2002,27595063,20066452,47661515
South Africa,ZAF,2003,28114892,19989156,48104048
South Africa,ZAF,2004,28644683,19911388,48556071
South Africa,ZAF,2005,29182849,19834298,49017147
South Africa,ZAF,2006,29733162,19758594,49491756
South Africa,ZAF,2007,30305632,19690462,49996094
South Africa,ZAF,2008,30923017,19642796,50565813
South Africa,ZAF,2009,31565718,19605060,51170778
South Africa,ZAF,2010,32219542,19565380,51784922
South Africa,ZAF,2011,32906089,19537236,52443325
South Africa,ZAF,2012,33625925,19519108,53145033
South Africa,ZAF,2013,34367596,19506020,53873616
South Africa,ZAF,2014,35197669,19531882,54729551
South Africa,ZAF,2015,36223620,19652884,55876504
South Africa,ZAF,2016,36866878,19555396,56422274
South Africa,ZAF,2017,37298236,19342972,56641208
South Africa,ZAF,2018,38047715,19291920,57339635
South Africa,ZAF,2019,38834681,19252374,58087055
South Africa,ZAF,2020,39605450,19196476,58801926
South Africa,ZAF,2021,40295863,19096392,59392255
South Asia (WB),,1960,95397367,475885660,571283027
South Asia (WB),,1961,98447279,486436220,584883499
South Asia (WB),,1962,101920474,496948930,598869404
South Asia (WB),,1963,105522024,507707500,613229524
South Asia (WB),,1964,109255055,518688320,627943375
South Asia (WB),,1965,113060512,529664130,642724642
South Asia (WB),,1966,116931723,540531260,657462983
South Asia (WB),,1967,120928157,551560300,672488457
South Asia (WB),,1968,125109881,562994370,688104251
South Asia (WB),,1969,129470885,574737660,704208545
South Asia (WB),,1970,133981542,586514600,720496142
South Asia (WB),,1971,138749731,597478900,736228631
South Asia (WB),,1972,144289750,608195840,752485590
South Asia (WB),,1973,150186375,619979600,770165975
South Asia (WB),,1974,156453848,631842940,788296788
South Asia (WB),,1975,163175818,643509200,806685018
South Asia (WB),,1976,170168712,655074240,825242952
South Asia (WB),,1977,177494454,666819460,844313914
South Asia (WB),,1978,185183413,678787650,863971063
South Asia (WB),,1979,193265872,690874200,884140072
South Asia (WB),,1980,201869717,703215550,905085267
South Asia (WB),,1981,210264416,716026050,926290466
South Asia (WB),,1982,217713336,730393000,948106336
South Asia (WB),,1983,225466507,745538000,971004507
South Asia (WB),,1984,233446861,760974700,994421561
South Asia (WB),,1985,241676374,776550340,1018226714
South Asia (WB),,1986,250157023,792102850,1042259873
South Asia (WB),,1987,258842790,807625860,1066468650
South Asia (WB),,1988,267789928,823319040,1091108968
South Asia (WB),,1989,276944827,839319040,1116263867
South Asia (WB),,1990,286253104,855181250,1141434354
South Asia (WB),,1991,295564374,871035300,1166599674
South Asia (WB),,1992,304787871,887714940,1192502811
South Asia (WB),,1993,314337082,904942200,1219279282
South Asia (WB),,1994,324127835,922112400,1246240235
South Asia (WB),,1995,334017695,938925400,1272943095
South Asia (WB),,1996,344049298,955402800,1299452098
South Asia (WB),,1997,354239136,971790660,1326029796
South Asia (WB),,1998,364610997,988242200,1352853197
South Asia (WB),,1999,375119671,1004748100,1379867771
South Asia (WB),,2000,385843630,1021103100,1406946730
South Asia (WB),,2001,397344050,1036962050,1434306100
South Asia (WB),,2002,409950738,1052071200,1462021938
South Asia (WB),,2003,422611571,1066667400,1489278971
South Asia (WB),,2004,435307330,1080292400,1515599730
South Asia (WB),,2005,448001350,1093133700,1541135050
South Asia (WB),,2006,460631298,1105086800,1565718098
South Asia (WB),,2007,473211288,1116006700,1589217988
South Asia (WB),,2008,485918296,1126489100,1612407396
South Asia (WB),,2009,498928274,1137124400,1636052674
South Asia (WB),,2010,512293887,1147845400,1660139287
South Asia (WB),,2011,525925036,1158511700,1684436736
South Asia (WB),,2012,539682037,1168432500,1708114537
South Asia (WB),,2013,553524624,1177612500,1731137124
South Asia (WB),,2014,567494427,1186074400,1753568827
South Asia (WB),,2015,581527189,1193651300,1775178489
South Asia (WB),,2016,595910612,1200939500,1796850112
South Asia (WB),,2017,610760436,1208108300,1818868736
South Asia (WB),,2018,625890168,1214644000,1840534168
South Asia (WB),,2019,641220797,1220377700,1861598497
South Asia (WB),,2020,656875632,1225655900,1882531532
South Asia (WB),,2021,672362364,1229549200,1901911564
South Korea,KOR,1960,6930929,18081444,25012373
South Korea,KOR,1961,7351204,18414468,25765672
South Korea,KOR,1962,7811004,18702026,26513030
South Korea,KOR,1963,8289479,18972268,27261747
South Korea,KOR,1964,8779189,19204966,27984155
South Korea,KOR,1965,9286249,19418424,28704673
South Korea,KOR,1966,9815880,19619692,29435572
South Korea,KOR,1967,10537106,19593876,30130982
South Korea,KOR,1968,11362681,19475620,30838301
South Korea,KOR,1969,12225296,19318970,31544266
South Korea,KOR,1970,13123306,19117520,32240826
South Korea,KOR,1971,13896560,18986144,32882704
South Korea,KOR,1972,14639182,18866224,33505406
South Korea,KOR,1973,15391092,18712056,34103148
South Korea,KOR,1974,16159311,18532956,34692267
South Korea,KOR,1975,16946391,18334334,35280725
South Korea,KOR,1976,17823527,18024996,35848523
South Korea,KOR,1977,18743336,17668460,36411796
South Korea,KOR,1978,19679806,17289380,36969186
South Korea,KOR,1979,20636698,16897538,37534236
South Korea,KOR,1980,21623805,16499970,38123775
South Korea,KOR,1981,22617087,16106161,38723248
South Korea,KOR,1982,23619800,15706552,39326352
South Korea,KOR,1983,24621925,15288478,39910403
South Korea,KOR,1984,25577374,14828582,40405956
South Korea,KOR,1985,26473134,14332610,40805744
South Korea,KOR,1986,27480866,13732808,41213674
South Korea,KOR,1987,28537079,13084611,41621690
South Korea,KOR,1988,29585374,12445873,42031247
South Korea,KOR,1989,30626132,11822906,42449038
South Korea,KOR,1990,31656393,11212890,42869283
South Korea,KOR,1991,32459655,10836049,43295704
South Korea,KOR,1992,33169705,10578257,43747962
South Korea,KOR,1993,33872973,10321655,44194628
South Korea,KOR,1994,34575766,10065774,44641540
South Korea,KOR,1995,35280305,9812686,45092991
South Korea,KOR,1996,35810625,9714056,45524681
South Korea,KOR,1997,36259672,9693908,45953580
South Korea,KOR,1998,36633453,9653050,46286503
South Korea,KOR,1999,37006183,9610494,46616677
South Korea,KOR,2000,37428328,9579783,47008111
South Korea,KOR,2001,37867709,9502455,47370164
South Korea,KOR,2002,38258247,9386489,47644736
South Korea,KOR,2003,38626122,9266208,47892330
South Korea,KOR,2004,38947802,9134717,48082519
South Korea,KOR,2005,39195731,8988830,48184561
South Korea,KOR,2006,39490771,8947521,48438292
South Korea,KOR,2007,39740941,8942697,48683638
South Korea,KOR,2008,40093884,8960824,49054708
South Korea,KOR,2009,40351067,8956768,49307835
South Korea,KOR,2010,40602657,8951455,49554112
South Korea,KOR,2011,40909592,9027046,49936638
South Korea,KOR,2012,41089082,9110771,50199853
South Korea,KOR,2013,41240244,9188649,50428893
South Korea,KOR,2014,41463573,9283086,50746659
South Korea,KOR,2015,41645542,9369405,51014947
South Korea,KOR,2016,41774264,9443539,51217803
South Korea,KOR,2017,41861498,9500413,51361911
South Korea,KOR,2018,42020672,9564386,51585058
South Korea,KOR,2019,42152095,9612727,51764822
South Korea,KOR,2020,42201956,9634283,51836239
South Korea,KOR,2021,42127573,9617303,51744876
South Sudan,SSD,1960,254368,2653356,2907724
South Sudan,SSD,1961,257650,2691303,2948953
South Sudan,SSD,1962,261076,2731194,2992270
South Sudan,SSD,1963,264578,2771660,3036238
South Sudan,SSD,1964,268779,2819922,3088701
South Sudan,SSD,1965,273181,2870441,3143622
South Sudan,SSD,1966,276453,2908852,3185305
South Sudan,SSD,1967,279247,2942710,3221957
South Sudan,SSD,1968,282335,2979390,3261725
South Sudan,SSD,1969,285449,3016443,3301892
South Sudan,SSD,1970,288550,3053860,3342410
South Sudan,SSD,1971,292873,3103935,3396808
South Sudan,SSD,1972,298312,3166403,3464715
South Sudan,SSD,1973,304617,3237848,3542465
South Sudan,SSD,1974,311674,3317934,3629608
South Sudan,SSD,1975,318880,3399399,3718279
South Sudan,SSD,1976,326208,3482407,3808615
South Sudan,SSD,1977,333656,3567388,3901044
South Sudan,SSD,1978,341331,3654580,3995911
South Sudan,SSD,1979,349156,3743636,4092792
South Sudan,SSD,1980,357118,3834894,4192012
South Sudan,SSD,1981,365322,3928544,4293866
South Sudan,SSD,1982,373723,4024574,4398297
South Sudan,SSD,1983,392081,4110460,4502541
South Sudan,SSD,1984,426287,4176752,4603039
South Sudan,SSD,1985,463355,4243620,4706975
South Sudan,SSD,1986,504185,4315482,4819667
South Sudan,SSD,1987,543751,4350058,4893809
South Sudan,SSD,1988,568011,4246868,4814879
South Sudan,SSD,1989,589128,4117498,4706626
South Sudan,SSD,1990,630718,4120099,4750817
South Sudan,SSD,1991,685008,4182177,4867185
South Sudan,SSD,1992,739183,4217786,4956969
South Sudan,SSD,1993,784140,4234032,5018172
South Sudan,SSD,1994,809949,4332914,5142863
South Sudan,SSD,1995,841593,4460449,5302042
South Sudan,SSD,1996,869420,4565474,5434894
South Sudan,SSD,1997,901181,4688229,5589410
South Sudan,SSD,1998,926101,4773335,5699436
South Sudan,SSD,1999,958020,4892125,5850145
South Sudan,SSD,2000,1009127,5105313,6114440
South Sudan,SSD,2001,1063522,5330909,6394431
South Sudan,SSD,2002,1120657,5565443,6686100
South Sudan,SSD,2003,1181081,5811286,6992367
South Sudan,SSD,2004,1245593,6071525,7317118
South Sudan,SSD,2005,1314452,6348202,7662654
South Sudan,SSD,2006,1388063,6641454,8029517
South Sudan,SSD,2007,1466385,6951438,8417823
South Sudan,SSD,2008,1549034,7274854,8823888
South Sudan,SSD,2009,1633665,7595562,9229227
South Sudan,SSD,2010,1734995,7979424,9714419
South Sudan,SSD,2011,1847027,8396023,10243050
South Sudan,SSD,2012,1949511,8752093,10701604
South Sudan,SSD,2013,2045176,9060855,11106031
South Sudan,SSD,2014,2088586,9124698,11213284
South Sudan,SSD,2015,2110349,9083950,11194299
South Sudan,SSD,2016,2112741,8953364,11066105
South Sudan,SSD,2017,2061940,8596286,10658226
South Sudan,SSD,2018,2039044,8356285,10395329
South Sudan,SSD,2019,2078981,8368685,10447666
South Sudan,SSD,2020,2142352,8463875,10606227
South Sudan,SSD,2021,2204901,8543371,10748272
Spain,ESP,1960,17227480,13227520,30455000
Spain,ESP,1961,17614512,13124738,30739250
Spain,ESP,1962,18089104,12934262,31023366
Spain,ESP,1963,18560792,12735859,31296651
Spain,ESP,1964,19059712,12549483,31609195
Spain,ESP,1965,19580951,12373341,31954292
Spain,ESP,1966,20096611,12186583,32283194
Spain,ESP,1967,20660198,12022749,32682947
Spain,ESP,1968,21248036,11865098,33113134
Spain,ESP,1969,21772801,11668253,33441054
Spain,ESP,1970,22330440,11484091,33814531
Spain,ESP,1971,22878387,11346103,34224490
Spain,ESP,1972,23372204,11232265,34604469
Spain,ESP,1973,23870859,11118088,34988947
Spain,ESP,1974,24372582,11000753,35373335
Spain,ESP,1975,24876771,10881129,35757900
Spain,ESP,1976,25379947,10757865,36137812
Spain,ESP,1977,25880544,10631094,36511638
Spain,ESP,1978,26368356,10496542,36864898
Spain,ESP,1979,26838008,10353322,37191330
Spain,ESP,1980,27289444,10201721,37491165
Spain,ESP,1981,27669147,10089484,37758631
Spain,ESP,1982,27925417,10060595,37986012
Spain,ESP,1983,28151118,10020407,38171525
Spain,ESP,1984,28357570,9972794,38330364
Spain,ESP,1985,28549379,9920133,38469512
Spain,ESP,1986,28723937,9860687,38584624
Spain,ESP,1987,28887112,9797703,38684815
Spain,ESP,1988,29036437,9730502,38766939
Spain,ESP,1989,29169746,9658018,38827764
Spain,ESP,1990,29286916,9580406,38867322
Spain,ESP,1991,29430524,9535852,38966376
Spain,ESP,1992,29607126,9550559,39157685
Spain,ESP,1993,29793326,9567936,39361262
Spain,ESP,1994,29967941,9581167,39549108
Spain,ESP,1995,30133075,9590975,39724050
Spain,ESP,1996,30291556,9598296,39889852
Spain,ESP,1997,30451227,9606162,40057389
Spain,ESP,1998,30610090,9613419,40223509
Spain,ESP,1999,30767125,9619750,40386875
Spain,ESP,2000,30937864,9630000,40567864
Spain,ESP,2001,31186430,9663982,40850412
Spain,ESP,2002,31708814,9722744,41431558
Spain,ESP,2003,32390830,9796815,42187645
Spain,ESP,2004,33059302,9862593,42921895
Spain,ESP,2005,33727737,9925418,43653155
Spain,ESP,2006,34408810,9988509,44397319
Spain,ESP,2007,35159317,10067486,45226803
Spain,ESP,2008,35833174,10120932,45954106
Spain,ESP,2009,36260460,10102486,46362946
Spain,ESP,2010,36535850,10041047,46576897
Spain,ESP,2011,36773882,9968815,46742697
Spain,ESP,2012,36904876,9868179,46773055
Spain,ESP,2013,36891840,9728205,46620045
Spain,ESP,2014,36890017,9590865,46480882
Spain,ESP,2015,36971015,9473817,46444832
Spain,ESP,2016,37112875,9371187,46484062
Spain,ESP,2017,37311863,9281373,46593236
Spain,ESP,2018,37588424,9209330,46797754
Spain,ESP,2019,37974181,9160656,47134837
Spain,ESP,2020,38276186,9089469,47365655
Spain,ESP,2021,38433310,8982440,47415750
Sri Lanka,LKA,1960,1622475,8252001,9874476
Sri Lanka,LKA,1961,1677723,8433916,10111639
Sri Lanka,LKA,1962,1734301,8617879,10352180
Sri Lanka,LKA,1963,1792676,8804840,10597516
Sri Lanka,LKA,1964,1846015,9003962,10849977
Sri Lanka,LKA,1965,1901062,9209763,11110825
Sri Lanka,LKA,1966,1958271,9422394,11380665
Sri Lanka,LKA,1967,2017240,9640410,11657650
Sri Lanka,LKA,1968,2077382,9860225,11937607
Sri Lanka,LKA,1969,2137616,10077332,12214948
Sri Lanka,LKA,1970,2197240,10288496,12485736
Sri Lanka,LKA,1971,2255984,10491847,12747831
Sri Lanka,LKA,1972,2313878,10688356,13002234
Sri Lanka,LKA,1973,2371584,10880449,13252033
Sri Lanka,LKA,1974,2429808,11072123,13501931
Sri Lanka,LKA,1975,2489268,11265873,13755141
Sri Lanka,LKA,1976,2550066,11462828,14012894
Sri Lanka,LKA,1977,2611907,11661588,14273495
Sri Lanka,LKA,1978,2674344,11859347,14533691
Sri Lanka,LKA,1979,2736532,12052334,14788866
Sri Lanka,LKA,1980,2797719,12238121,15035840
Sri Lanka,LKA,1981,2852352,12420470,15272822
Sri Lanka,LKA,1982,2892526,12608684,15501210
Sri Lanka,LKA,1983,2931702,12792939,15724641
Sri Lanka,LKA,1984,2971046,12977455,15948501
Sri Lanka,LKA,1985,3010891,13165391,16176282
Sri Lanka,LKA,1986,3051556,13357305,16408861
Sri Lanka,LKA,1987,3092780,13551176,16643956
Sri Lanka,LKA,1988,3133604,13744582,16878186
Sri Lanka,LKA,1989,3173474,13933278,17106752
Sri Lanka,LKA,1990,3211331,14114438,17325769
Sri Lanka,LKA,1991,3247618,14288114,17535732
Sri Lanka,LKA,1992,3282022,14454805,17736827
Sri Lanka,LKA,1993,3314121,14610706,17924827
Sri Lanka,LKA,1994,3342592,14751882,18094474
Sri Lanka,LKA,1995,3367278,14875639,18242917
Sri Lanka,LKA,1996,3387296,14979994,18367290
Sri Lanka,LKA,1997,3403632,15067265,18470897
Sri Lanka,LKA,1998,3417928,15146667,18564595
Sri Lanka,LKA,1999,3433299,15229994,18663293
Sri Lanka,LKA,2000,3451324,15326282,18777606
Sri Lanka,LKA,2001,3473139,15438588,18911727
Sri Lanka,LKA,2002,3497774,15564702,19062476
Sri Lanka,LKA,2003,3524535,15699501,19224036
Sri Lanka,LKA,2004,3551533,15835620,19387153
Sri Lanka,LKA,2005,3577319,15967669,19544988
Sri Lanka,LKA,2006,3602000,16093977,19695977
Sri Lanka,LKA,2007,3625538,16216506,19842044
Sri Lanka,LKA,2008,3648476,16335508,19983984
Sri Lanka,LKA,2009,3670930,16452578,20123508
Sri Lanka,LKA,2010,3692904,16568834,20261738
Sri Lanka,LKA,2011,3714770,16683726,20398496
Sri Lanka,LKA,2012,3716533,16708467,20425000
Sri Lanka,LKA,2013,3746058,16838942,20585000
Sri Lanka,LKA,2014,3785336,16992664,20778000
Sri Lanka,LKA,2015,3828283,17141716,20969999
Sri Lanka,LKA,2016,3882481,17320520,21203001
Sri Lanka,LKA,2017,3942265,17501736,21444001
Sri Lanka,LKA,2018,4003749,17666252,21670001
Sri Lanka,LKA,2019,4052088,17750912,21803000
Sri Lanka,LKA,2020,4101702,17817298,21919000
Sri Lanka,LKA,2021,4178622,17977378,22156000
Sub-Saharan Africa (WB),,1960,33335738,194613140,227948878
Sub-Saharan Africa (WB),,1961,34858964,198624300,233483264
Sub-Saharan Africa (WB),,1962,36478617,202802000,239280617
Sub-Saharan Africa (WB),,1963,38218062,207080000,245298062
Sub-Saharan Africa (WB),,1964,40075487,211490480,251565967
Sub-Saharan Africa (WB),,1965,42048203,216030350,258078553
Sub-Saharan Africa (WB),,1966,44091894,220662110,264754004
Sub-Saharan Africa (WB),,1967,46243108,225390080,271633188
Sub-Saharan Africa (WB),,1968,48519795,230277100,278796895
Sub-Saharan Africa (WB),,1969,50925574,235286320,286211894
Sub-Saharan Africa (WB),,1970,53407612,240492940,293900552
Sub-Saharan Africa (WB),,1971,56090894,245748340,301839234
Sub-Saharan Africa (WB),,1972,58934072,251029060,309963132
Sub-Saharan Africa (WB),,1973,61926821,256537940,318464761
Sub-Saharan Africa (WB),,1974,65058517,262408340,327466857
Sub-Saharan Africa (WB),,1975,68364923,268468000,336832923
Sub-Saharan Africa (WB),,1976,71829737,274631330,346461067
Sub-Saharan Africa (WB),,1977,75386135,280857630,356243765
Sub-Saharan Africa (WB),,1978,79207851,287480220,366688071
Sub-Saharan Africa (WB),,1979,83092487,294683170,377775657
Sub-Saharan Africa (WB),,1980,87018684,301774800,388793484
Sub-Saharan Africa (WB),,1981,91254530,309006240,400260770
Sub-Saharan Africa (WB),,1982,95711811,316698300,412410111
Sub-Saharan Africa (WB),,1983,100381452,323964930,424346382
Sub-Saharan Africa (WB),,1984,105368499,330895140,436263639
Sub-Saharan Africa (WB),,1985,110817541,337937900,448755441
Sub-Saharan Africa (WB),,1986,116650964,345105200,461756164
Sub-Saharan Africa (WB),,1987,122764568,352485800,475250368
Sub-Saharan Africa (WB),,1988,129031912,359733000,488764912
Sub-Saharan Africa (WB),,1989,135479864,367037220,502517084
Sub-Saharan Africa (WB),,1990,142129313,374500380,516629693
Sub-Saharan Africa (WB),,1991,148335300,382381660,530716960
Sub-Saharan Africa (WB),,1992,154639169,390260450,544899619
Sub-Saharan Africa (WB),,1993,161165932,398247970,559413902
Sub-Saharan Africa (WB),,1994,167842807,406251330,574094137
Sub-Saharan Africa (WB),,1995,174614098,414714000,589328098
Sub-Saharan Africa (WB),,1996,181348752,423837300,605186052
Sub-Saharan Africa (WB),,1997,188310397,432754940,621065337
Sub-Saharan Africa (WB),,1998,195525671,441672830,637198501
Sub-Saharan Africa (WB),,1999,203014745,450868500,653883245
Sub-Saharan Africa (WB),,2000,210824543,460387940,671212483
Sub-Saharan Africa (WB),,2001,219400444,469761540,689161984
Sub-Saharan Africa (WB),,2002,228391489,479301950,707693439
Sub-Saharan Africa (WB),,2003,237743572,489041860,726785432
Sub-Saharan Africa (WB),,2004,247522643,499024160,746546803
Sub-Saharan Africa (WB),,2005,257825161,509153500,766978661
Sub-Saharan Africa (WB),,2006,268533982,519576030,788110012
Sub-Saharan Africa (WB),,2007,279364356,530654900,810019256
Sub-Saharan Africa (WB),,2008,291355929,541286800,832642729
Sub-Saharan Africa (WB),,2009,303836244,552049500,855885744
Sub-Saharan Africa (WB),,2010,316860625,562936770,879797395
Sub-Saharan Africa (WB),,2011,330397705,573884500,904282205
Sub-Saharan Africa (WB),,2012,344302619,585026050,929328669
Sub-Saharan Africa (WB),,2013,358752097,596344300,955096397
Sub-Saharan Africa (WB),,2014,373846598,607659700,981506298
Sub-Saharan Africa (WB),,2015,389673544,619024960,1008698504
Sub-Saharan Africa (WB),,2016,405767939,630387800,1036155739
Sub-Saharan Africa (WB),,2017,422226126,641658900,1063885026
Sub-Saharan Africa (WB),,2018,439414417,652989300,1092403717
Sub-Saharan Africa (WB),,2019,457135236,664413600,1121548836
Sub-Saharan Africa (WB),,2020,475423365,675878460,1151301825
Sub-Saharan Africa (WB),,2021,494081001,687081700,1181162701
Sudan,SDN,1960,894762,7431700,8326462
Sudan,SDN,1961,963424,7614066,8577490
Sudan,SDN,1962,1037708,7803630,8841338
Sudan,SDN,1963,1117692,7997399,9115091
Sudan,SDN,1964,1204810,8201892,9406702
Sudan,SDN,1965,1298891,8413894,9712785
Sudan,SDN,1966,1397925,8616580,10014505
Sudan,SDN,1967,1503387,8817113,10320500
Sudan,SDN,1968,1616793,9022106,10638899
Sudan,SDN,1969,1737915,9228230,10966145
Sudan,SDN,1970,1867959,9437247,11305206
Sudan,SDN,1971,2009388,9659533,11668921
Sudan,SDN,1972,2163193,9894067,12057260
Sudan,SDN,1973,2312860,10156731,12469591
Sudan,SDN,1974,2427528,10523434,12950962
Sudan,SDN,1975,2556840,10940703,13497543
Sudan,SDN,1976,2692656,11373351,14066007
Sudan,SDN,1977,2837227,11829991,14667218
Sudan,SDN,1978,2991826,12313980,15305806
Sudan,SDN,1979,3154994,12818040,15973034
Sudan,SDN,1980,3327881,13345705,16673586
Sudan,SDN,1981,3509758,13894578,17404336
Sudan,SDN,1982,3693890,14434741,18128631
Sudan,SDN,1983,3915592,14818403,18733995
Sudan,SDN,1984,4197893,14967944,19165837
Sudan,SDN,1985,4476659,15040537,19517196
Sudan,SDN,1986,4773983,15113469,19887452
Sudan,SDN,1987,5079280,15151252,20230532
Sudan,SDN,1988,5367900,15085919,20453819
Sudan,SDN,1989,5678998,15039711,20718709
Sudan,SDN,1990,6034102,15056784,21090886
Sudan,SDN,1991,6401787,15051924,21453711
Sudan,SDN,1992,6774252,15005807,21780059
Sudan,SDN,1993,7120388,15042863,22163251
Sudan,SDN,1994,7305801,15397830,22703631
Sudan,SDN,1995,7507027,15783575,23290602
Sudan,SDN,1996,7703691,16158567,23862258
Sudan,SDN,1997,7907810,16546562,24454372
Sudan,SDN,1998,8106940,16922204,25029144
Sudan,SDN,1999,8316235,17317928,25634163
Sudan,SDN,2000,8545786,17752988,26298774
Sudan,SDN,2001,8770792,18176460,26947252
Sudan,SDN,2002,8988199,18582120,27570319
Sudan,SDN,2003,9204829,18984148,28188977
Sudan,SDN,2004,9429935,19401616,28831551
Sudan,SDN,2005,9677493,19863084,29540577
Sudan,SDN,2006,9953157,20379812,30332969
Sudan,SDN,2007,10251288,20939876,31191164
Sudan,SDN,2008,10555557,21509684,32065241
Sudan,SDN,2009,10870585,22077570,32948155
Sudan,SDN,2010,11164206,22575728,33739934
Sudan,SDN,2011,11429725,22989900,34419625
Sudan,SDN,2012,11724384,23435408,35159792
Sudan,SDN,2013,12059405,23931300,35990705
Sudan,SDN,2014,12466023,24537222,37003245
Sudan,SDN,2015,12937739,25233440,38171179
Sudan,SDN,2016,13435884,25941284,39377168
Sudan,SDN,2017,13981657,26698172,40679829
Sudan,SDN,2018,14549314,27449744,41999058
Sudan,SDN,2019,15103564,28128528,43232092
Sudan,SDN,2020,15666605,28773880,44440485
Sudan,SDN,2021,16250768,29406434,45657202
Suriname,SUR,1960,126844,141552,268396
Suriname,SUR,1961,131471,146498,277969
Suriname,SUR,1962,136463,151828,288291
Suriname,SUR,1963,141800,157532,299332
Suriname,SUR,1964,146893,163395,310288
Suriname,SUR,1965,151252,169817,321069
Suriname,SUR,1966,155698,176444,332142
Suriname,SUR,1967,160278,183342,343620
Suriname,SUR,1968,164980,190488,355468
Suriname,SUR,1969,169766,197852,367618
Suriname,SUR,1970,174565,205353,379918
Suriname,SUR,1971,179219,212807,392026
Suriname,SUR,1972,185885,211644,397529
Suriname,SUR,1973,194547,201784,396331
Suriname,SUR,1974,202866,191653,394519
Suriname,SUR,1975,210770,181367,392137
Suriname,SUR,1976,218218,171013,389231
Suriname,SUR,1977,225105,160705,385810
Suriname,SUR,1978,231411,150474,381885
Suriname,SUR,1979,236995,140367,377362
Suriname,SUR,1980,243673,131439,375112
Suriname,SUR,1981,244440,131419,375859
Suriname,SUR,1982,245652,131636,377288
Suriname,SUR,1983,247314,132095,379409
Suriname,SUR,1984,249692,132925,382617
Suriname,SUR,1985,252954,134217,387171
Suriname,SUR,1986,256643,135729,392372
Suriname,SUR,1987,259880,136987,396867
Suriname,SUR,1988,263630,138509,402139
Suriname,SUR,1989,268015,140345,408360
Suriname,SUR,1990,271205,141551,412756
Suriname,SUR,1991,273632,142349,415981
Suriname,SUR,1992,276271,143250,419521
Suriname,SUR,1993,278463,143912,422375
Suriname,SUR,1994,281530,145018,426548
Suriname,SUR,1995,287094,147396,434490
Suriname,SUR,1996,293596,150238,443834
Suriname,SUR,1997,299915,152972,452887
Suriname,SUR,1998,306126,155623,461749
Suriname,SUR,1999,312248,158210,470458
Suriname,SUR,2000,318265,160733,478998
Suriname,SUR,2001,324200,163194,487394
Suriname,SUR,2002,330069,165597,495666
Suriname,SUR,2003,335840,167940,503780
Suriname,SUR,2004,340740,169832,510572
Suriname,SUR,2005,344226,171994,516220
Suriname,SUR,2006,347746,174277,522023
Suriname,SUR,2007,351332,176614,527946
Suriname,SUR,2008,354957,178981,533938
Suriname,SUR,2009,358616,181371,539987
Suriname,SUR,2010,362291,183789,546080
Suriname,SUR,2011,365940,186206,552146
Suriname,SUR,2012,369514,188597,558111
Suriname,SUR,2013,372995,190952,563947
Suriname,SUR,2014,376497,193185,569682
Suriname,SUR,2015,380136,195339,575475
Suriname,SUR,2016,383992,197461,581453
Suriname,SUR,2017,388030,199529,587559
Suriname,SUR,2018,392208,201507,593715
Suriname,SUR,2019,396769,203532,600301
Suriname,SUR,2020,401567,205498,607065
Suriname,SUR,2021,405913,207072,612985
Sweden,SWE,1960,5425627,2059029,7484656
Sweden,SWE,1961,5511783,2008215,7519998
Sweden,SWE,1962,5616067,1945521,7561588
Sweden,SWE,1963,5720204,1884124,7604328
Sweden,SWE,1964,5834351,1827003,7661354
Sweden,SWE,1965,5959398,1774455,7733853
Sweden,SWE,1966,6083367,1724430,7807797
Sweden,SWE,1967,6194186,1673745,7867931
Sweden,SWE,1968,6291760,1620513,7912273
Sweden,SWE,1969,6397326,1570746,7968072
Sweden,SWE,1970,6517403,1525398,8042801
Sweden,SWE,1971,6605244,1493090,8098334
Sweden,SWE,1972,6651027,1471273,8122300
Sweden,SWE,1973,6688293,1448019,8136312
Sweden,SWE,1974,6733350,1426605,8159955
Sweden,SWE,1975,6777603,1414834,8192437
Sweden,SWE,1976,6808217,1414069,8222286
Sweden,SWE,1977,6838299,1413241,8251540
Sweden,SWE,1978,6864113,1411486,8275599
Sweden,SWE,1979,6885080,1408598,8293678
Sweden,SWE,1980,6904971,1405560,8310531
Sweden,SWE,1981,6914338,1406165,8320503
Sweden,SWE,1982,6918294,1406969,8325263
Sweden,SWE,1983,6921426,1407607,8329033
Sweden,SWE,1984,6927719,1408886,8336605
Sweden,SWE,1985,6939171,1411215,8350386
Sweden,SWE,1986,6955328,1414501,8369829
Sweden,SWE,1987,6978575,1419229,8397804
Sweden,SWE,1988,7010722,1425767,8436489
Sweden,SWE,1989,7057653,1435311,8492964
Sweden,SWE,1990,7112392,1446443,8558835
Sweden,SWE,1991,7170001,1447374,8617375
Sweden,SWE,1992,7225787,1442280,8668067
Sweden,SWE,1993,7281393,1437168,8718561
Sweden,SWE,1994,7346937,1433808,8780745
Sweden,SWE,1995,7399093,1427846,8826939
Sweden,SWE,1996,7418835,1422163,8840998
Sweden,SWE,1997,7425561,1420501,8846062
Sweden,SWE,1998,7432163,1418811,8850974
Sweden,SWE,1999,7440437,1417437,8857874
Sweden,SWE,2000,7454878,1417231,8872109
Sweden,SWE,2001,7478923,1417037,8895960
Sweden,SWE,2002,7508835,1416123,8924958
Sweden,SWE,2003,7542470,1415759,8958229
Sweden,SWE,2004,7577769,1415762,8993531
Sweden,SWE,2005,7613645,1415927,9029572
Sweden,SWE,2006,7666670,1413835,9080505
Sweden,SWE,2007,7738188,1409904,9148092
Sweden,SWE,2008,7813274,1406363,9219637
Sweden,SWE,2009,7894625,1403890,9298515
Sweden,SWE,2010,7976659,1401467,9378126
Sweden,SWE,2011,8059895,1389318,9449213
Sweden,SWE,2012,8150488,1368886,9519374
Sweden,SWE,2013,8250182,1350197,9600379
Sweden,SWE,2014,8362604,1333506,9696110
Sweden,SWE,2015,8481489,1317697,9799186
Sweden,SWE,2016,8618398,1304687,9923085
Sweden,SWE,2017,8764881,1292817,10057698
Sweden,SWE,2018,8896291,1278923,10175214
Sweden,SWE,2019,9015406,1263481,10278887
Sweden,SWE,2020,9108648,1244794,10353442
Sweden,SWE,2021,9190703,1225108,10415811
Switzerland,CHE,1960,3778708,1549119,5327827
Switzerland,CHE,1961,3871554,1562740,5434294
Switzerland,CHE,1962,3987452,1586363,5573815
Switzerland,CHE,1963,4090405,1603842,5694247
Switzerland,CHE,1964,4175596,1613632,5789228
Switzerland,CHE,1965,4241081,1615391,5856472
Switzerland,CHE,1966,4302743,1615259,5918002
Switzerland,CHE,1967,4373584,1618201,5991785
Switzerland,CHE,1968,4446360,1621354,6067714
Switzerland,CHE,1969,4513988,1622399,6136387
Switzerland,CHE,1970,4564145,1616732,6180877
Switzerland,CHE,1971,4597418,1615981,6213399
Switzerland,CHE,1972,4635987,1624969,6260956
Switzerland,CHE,1973,4673744,1633603,6307347
Switzerland,CHE,1974,4702405,1639000,6341405
Switzerland,CHE,1975,4703772,1634860,6338632
Switzerland,CHE,1976,4680366,1622138,6302504
Switzerland,CHE,1977,4667917,1613257,6281174
Switzerland,CHE,1978,4671729,1610009,6281738
Switzerland,CHE,1979,4684518,1609847,6294365
Switzerland,CHE,1980,4706505,1612903,6319408
Switzerland,CHE,1981,4731625,1622449,6354074
Switzerland,CHE,1982,4755517,1635792,6391309
Switzerland,CHE,1983,4772101,1646672,6418773
Switzerland,CHE,1984,4785404,1656461,6441865
Switzerland,CHE,1985,4802758,1667607,6470365
Switzerland,CHE,1986,4823914,1680210,6504124
Switzerland,CHE,1987,4850382,1694724,6545106
Switzerland,CHE,1988,4882139,1711247,6593386
Switzerland,CHE,1989,4917784,1729128,6646912
Switzerland,CHE,1990,4964515,1751004,6715519
Switzerland,CHE,1991,5023076,1776902,6799978
Switzerland,CHE,1992,5075050,1800314,6875364
Switzerland,CHE,1993,5117803,1820462,6938265
Switzerland,CHE,1994,5154986,1838809,6993795
Switzerland,CHE,1995,5185748,1854939,7040687
Switzerland,CHE,1996,5204882,1866968,7071850
Switzerland,CHE,1997,5213607,1875299,7088906
Switzerland,CHE,1998,5225282,1884719,7110001
Switzerland,CHE,1999,5246404,1897587,7143991
Switzerland,CHE,2000,5272018,1912232,7184250
Switzerland,CHE,2001,5304905,1924949,7229854
Switzerland,CHE,2002,5347082,1937671,7284753
Switzerland,CHE,2003,5388808,1950193,7339001
Switzerland,CHE,2004,5427827,1961798,7389625
Switzerland,CHE,2005,5464643,1972472,7437115
Switzerland,CHE,2006,5500991,1982943,7483934
Switzerland,CHE,2007,5552336,1998781,7551117
Switzerland,CHE,2008,5625324,2022351,7647675
Switzerland,CHE,2009,5697988,2045843,7743831
Switzerland,CHE,2010,5759681,2065228,7824909
Switzerland,CHE,2011,5825978,2086420,7912398
Switzerland,CHE,2012,5889928,2106933,7996861
Switzerland,CHE,2013,5959745,2129601,8089346
Switzerland,CHE,2014,6034707,2153942,8188649
Switzerland,CHE,2015,6105617,2176779,8282396
Switzerland,CHE,2016,6174416,2198922,8373338
Switzerland,CHE,2017,6234162,2217678,8451840
Switzerland,CHE,2018,6283319,2231010,8514329
Switzerland,CHE,2019,6332759,2242521,8575280
Switzerland,CHE,2020,6384901,2253266,8638167
Switzerland,CHE,2021,6440172,2263233,8703405
Syria,SYR,1960,1697065,2913647,4610712
Syria,SYR,1961,1777026,2974508,4751534
Syria,SYR,1962,1862252,3032743,4894995
Syria,SYR,1963,1952207,3093038,5045245
Syria,SYR,1964,2047268,3155578,5202846
Syria,SYR,1965,2147703,3220748,5368451
Syria,SYR,1966,2253766,3288237,5542003
Syria,SYR,1967,2365557,3357749,5723306
Syria,SYR,1968,2483399,3429316,5912715
Syria,SYR,1969,2607780,3503584,6111364
Syria,SYR,1970,2739057,3580142,6319199
Syria,SYR,1971,2860671,3677855,6538526
Syria,SYR,1972,2983439,3785105,6768544
Syria,SYR,1973,3109733,3893381,7003114
Syria,SYR,1974,3240862,4004039,7244901
Syria,SYR,1975,3378280,4118846,7497126
Syria,SYR,1976,3521662,4237011,7758673
Syria,SYR,1977,3670841,4358472,8029313
Syria,SYR,1978,3826689,4483528,8310217
Syria,SYR,1979,3988768,4611979,8600747
Syria,SYR,1980,4156523,4742431,8898954
Syria,SYR,1981,4329206,4874429,9203635
Syria,SYR,1982,4495543,5015211,9510754
Syria,SYR,1983,4669483,5165978,9835461
Syria,SYR,1984,4855728,5327410,10183138
Syria,SYR,1985,5048155,5492771,10540926
Syria,SYR,1986,5246456,5661163,10907619
Syria,SYR,1987,5449564,5831543,11281107
Syria,SYR,1988,5655768,6002004,11657772
Syria,SYR,1989,5863373,6170724,12034097
Syria,SYR,1990,6071846,6337150,12408996
Syria,SYR,1991,6281085,6501196,12782281
Syria,SYR,1992,6492292,6664114,13156406
Syria,SYR,1993,6708290,6828770,13537060
Syria,SYR,1994,6928456,6994170,13922626
Syria,SYR,1995,7171611,7141839,14313450
Syria,SYR,1996,7424012,7284867,14708879
Syria,SYR,1997,7679023,7424973,15103996
Syria,SYR,1998,7937828,7562714,15500542
Syria,SYR,1999,8201521,7699680,15901201
Syria,SYR,2000,8471337,7836317,16307654
Syria,SYR,2001,8751059,7976889,16727948
Syria,SYR,2002,9042350,8121671,17164021
Syria,SYR,2003,9342648,8268708,17611356
Syria,SYR,2004,9659934,8424073,18084007
Syria,SYR,2005,9994609,8588948,18583557
Syria,SYR,2006,10521656,8910353,19432009
Syria,SYR,2007,11285415,9417590,20703005
Syria,SYR,2008,11783890,9690169,21474059
Syria,SYR,2009,12056702,9770518,21827220
Syria,SYR,2010,12419685,9917878,22337563
Syria,SYR,2011,12406434,10324299,22730733
Syria,SYR,2012,12106417,10499160,22605577
Syria,SYR,2013,11291540,10204281,21495821
Syria,SYR,2014,10337199,9735033,20072232
Syria,SYR,2015,10018957,9186221,19205178
Syria,SYR,2016,10019763,8944489,18964252
Syria,SYR,2017,10156105,8827268,18983373
Syria,SYR,2018,10471390,8862073,19333463
Syria,SYR,2019,11018062,9080189,20098251
Syria,SYR,2020,11523597,9248998,20772595
Syria,SYR,2021,11968088,9356279,21324367
Tajikistan,TJK,1960,707139,1424853,2131992
Tajikistan,TJK,1961,741014,1467012,2208026
Tajikistan,TJK,1962,776612,1510569,2287181
Tajikistan,TJK,1963,813730,1555138,2368868
Tajikistan,TJK,1964,852328,1600343,2452671
Tajikistan,TJK,1965,892261,1646034,2538295
Tajikistan,TJK,1966,933551,1692102,2625653
Tajikistan,TJK,1967,976299,1738660,2714959
Tajikistan,TJK,1968,1020692,1785874,2806566
Tajikistan,TJK,1969,1066479,1833375,2899854
Tajikistan,TJK,1970,1103706,1889313,2993019
Tajikistan,TJK,1971,1129678,1956283,3085961
Tajikistan,TJK,1972,1155684,2024777,3180461
Tajikistan,TJK,1973,1182190,2095297,3277487
Tajikistan,TJK,1974,1209305,2168453,3377758
Tajikistan,TJK,1975,1237408,2244717,3482125
Tajikistan,TJK,1976,1266407,2324199,3590606
Tajikistan,TJK,1977,1296276,2406734,3703010
Tajikistan,TJK,1978,1326527,2491587,3818114
Tajikistan,TJK,1979,1356854,2575828,3932682
Tajikistan,TJK,1980,1387321,2658644,4045965
Tajikistan,TJK,1981,1417899,2742846,4160745
Tajikistan,TJK,1982,1449095,2829813,4278908
Tajikistan,TJK,1983,1481325,2920177,4401502
Tajikistan,TJK,1984,1514892,3014609,4529501
Tajikistan,TJK,1985,1548950,3111648,4660598
Tajikistan,TJK,1986,1584680,3213601,4798281
Tajikistan,TJK,1987,1623274,3323019,4946293
Tajikistan,TJK,1988,1663117,3436903,5100020
Tajikistan,TJK,1989,1696747,3567585,5264332
Tajikistan,TJK,1990,1715186,3702674,5417860
Tajikistan,TJK,1991,1727456,3828850,5556306
Tajikistan,TJK,1992,1726671,3929537,5656208
Tajikistan,TJK,1993,1713741,4004065,5717806
Tajikistan,TJK,1994,1707593,4096400,5803993
Tajikistan,TJK,1995,1708413,4207760,5916173
Tajikistan,TJK,1996,1710368,4325232,6035600
Tajikistan,TJK,1997,1700912,4416157,6117069
Tajikistan,TJK,1998,1679576,4477229,6156805
Tajikistan,TJK,1999,1656328,4533237,6189565
Tajikistan,TJK,2000,1662407,4610591,6272998
Tajikistan,TJK,2001,1698527,4710283,6408810
Tajikistan,TJK,2002,1733892,4807863,6541755
Tajikistan,TJK,2003,1768677,4903815,6672492
Tajikistan,TJK,2004,1802863,4998341,6801204
Tajikistan,TJK,2005,1836916,5092229,6929145
Tajikistan,TJK,2006,1871062,5186355,7057417
Tajikistan,TJK,2007,1905930,5282461,7188391
Tajikistan,TJK,2008,1942198,5382429,7324627
Tajikistan,TJK,2009,1980522,5488074,7468596
Tajikistan,TJK,2010,2021296,5600483,7621779
Tajikistan,TJK,2011,2064612,5720207,7784819
Tajikistan,TJK,2012,2112022,5844360,7956382
Tajikistan,TJK,2013,2163443,5973167,8136610
Tajikistan,TJK,2014,2219388,6106960,8326348
Tajikistan,TJK,2015,2279505,6244558,8524063
Tajikistan,TJK,2016,2342835,6382483,8725318
Tajikistan,TJK,2017,2408285,6517240,8925525
Tajikistan,TJK,2018,2476827,6651305,9128132
Tajikistan,TJK,2019,2549842,6787161,9337003
Tajikistan,TJK,2020,2624955,6918252,9543207
Tajikistan,TJK,2021,2703303,7046761,9750064
Tanzania,TZA,1960,526827,9515631,10042458
Tanzania,TZA,1961,557626,9780265,10337891
Tanzania,TZA,1962,590457,10054165,10644622
Tanzania,TZA,1963,625168,10334993,10960161
Tanzania,TZA,1964,662132,10627424,11289556
Tanzania,TZA,1965,701325,10929278,11630603
Tanzania,TZA,1966,742760,11239172,11981932
Tanzania,TZA,1967,786829,11559457,12346286
Tanzania,TZA,1968,866827,11873138,12739965
Tanzania,TZA,1969,962697,12205085,13167782
Tanzania,TZA,1970,1069300,12548892,13618192
Tanzania,TZA,1971,1188115,12904103,14092218
Tanzania,TZA,1972,1320619,13275080,14595699
Tanzania,TZA,1973,1467585,13655919,15123504
Tanzania,TZA,1974,1630287,14041029,15671316
Tanzania,TZA,1975,1810537,14433289,16243826
Tanzania,TZA,1976,2010062,14828857,16838919
Tanzania,TZA,1977,2229480,15225147,17454627
Tanzania,TZA,1978,2469548,15610457,18080005
Tanzania,TZA,1979,2644174,16054462,18698636
Tanzania,TZA,1980,2808774,16488885,19297659
Tanzania,TZA,1981,2978866,16912064,19890930
Tanzania,TZA,1982,3158833,17341088,20499921
Tanzania,TZA,1983,3355770,17814948,21170718
Tanzania,TZA,1984,3563813,18293364,21857177
Tanzania,TZA,1985,3784249,18785376,22569625
Tanzania,TZA,1986,4021337,19302932,23324269
Tanzania,TZA,1987,4271621,19827794,24099415
Tanzania,TZA,1988,4526852,20317296,24844148
Tanzania,TZA,1989,4738326,20784572,25522898
Tanzania,TZA,1990,4948743,21257268,26206011
Tanzania,TZA,1991,5165205,21725700,26890905
Tanzania,TZA,1992,5388170,22192552,27580722
Tanzania,TZA,1993,5655940,22813076,28469016
Tanzania,TZA,1994,5979749,23618574,29598323
Tanzania,TZA,1995,6277955,24282116,30560071
Tanzania,TZA,1996,6504676,24636056,31140732
Tanzania,TZA,1997,6750360,25035486,31785846
Tanzania,TZA,1998,7044061,25582436,32626497
Tanzania,TZA,1999,7352195,26147576,33499771
Tanzania,TZA,2000,7688508,26775196,34463704
Tanzania,TZA,2001,8029877,27384592,35414469
Tanzania,TZA,2002,8377308,27976224,36353532
Tanzania,TZA,2003,8814911,28519008,37333919
Tanzania,TZA,2004,9292156,29068724,38360880
Tanzania,TZA,2005,9798745,29640760,39439505
Tanzania,TZA,2006,10334400,30227652,40562052
Tanzania,TZA,2007,10896766,30819732,41716498
Tanzania,TZA,2008,11479108,31391776,42870884
Tanzania,TZA,2009,12061617,31896316,43957933
Tanzania,TZA,2010,12682374,32428152,45110526
Tanzania,TZA,2011,13366889,33049142,46416031
Tanzania,TZA,2012,14093565,33692572,47786137
Tanzania,TZA,2013,14872630,34381012,49253642
Tanzania,TZA,2014,15703729,35110824,50814553
Tanzania,TZA,2015,16612464,35930360,52542824
Tanzania,TZA,2016,17589735,36812068,54401803
Tanzania,TZA,2017,18597942,37669090,56267032
Tanzania,TZA,2018,19620628,38469816,58090444
Tanzania,TZA,2019,20656040,39216540,59872580
Tanzania,TZA,2020,21736651,39967868,61704519
Tanzania,TZA,2021,22862550,40725784,63588334
Thailand,THA,1960,5232080,21364504,26596584
Thailand,THA,1961,5419987,21979976,27399963
Thailand,THA,1962,5617368,22624806,28242174
Thailand,THA,1963,5822825,23291300,29114125
Thailand,THA,1964,6035730,23977844,30013574
Thailand,THA,1965,6256432,24683838,30940270
Thailand,THA,1966,6482605,25401148,31883753
Thailand,THA,1967,6713675,26125666,32839341
Thailand,THA,1968,6949440,26857916,33807356
Thailand,THA,1969,7189898,27597684,34787582
Thailand,THA,1970,7476534,28315194,35791728
Thailand,THA,1971,7892371,28915626,36807997
Thailand,THA,1972,8325835,29508548,37834383
Thailand,THA,1973,8777148,30095912,38873060
Thailand,THA,1974,9242659,30658302,39900961
Thailand,THA,1975,9719035,31189436,40908471
Thailand,THA,1976,10204580,31677548,41882128
Thailand,THA,1977,10702382,32141420,42843802
Thailand,THA,1978,11217147,32589568,43806715
Thailand,THA,1979,11745943,33014148,44760091
Thailand,THA,1980,12253601,33484152,45737753
Thailand,THA,1981,12639265,34088028,46727293
Thailand,THA,1982,13026009,34674332,47700341
Thailand,THA,1983,13417988,35252576,48670564
Thailand,THA,1984,13814893,35821830,49636723
Thailand,THA,1985,14214648,36380292,50594940
Thailand,THA,1986,14617853,36924240,51542093
Thailand,THA,1987,15023740,37455440,52479180
Thailand,THA,1988,15434167,37976800,53410967
Thailand,THA,1989,15844682,38479320,54324002
Thailand,THA,1990,16250407,38978004,55228411
Thailand,THA,1991,16601633,39498230,56099863
Thailand,THA,1992,16946761,39992260,56939021
Thailand,THA,1993,17294692,40481390,57776082
Thailand,THA,1994,17644544,40965464,58610008
Thailand,THA,1995,17991463,41433372,59424835
Thailand,THA,1996,18333677,41877420,60211097
Thailand,THA,1997,18676085,42313024,60989109
Thailand,THA,1998,19014440,42730776,61745216
Thailand,THA,1999,19337865,43104784,62442649
Thailand,THA,2000,19794084,43272520,63066604
Thailand,THA,2001,20716767,42933124,63649891
Thailand,THA,2002,21664845,42557736,64222581
Thailand,THA,2003,22633716,42143240,64776956
Thailand,THA,2004,23622396,41688770,65311166
Thailand,THA,2005,24624429,41196932,65821361
Thailand,THA,2006,25647750,40671776,66319526
Thailand,THA,2007,26697288,40129464,66826752
Thailand,THA,2008,27767512,39560730,67328242
Thailand,THA,2009,28849963,38963692,67813655
Thailand,THA,2010,29940706,38329784,68270490
Thailand,THA,2011,30713268,37999576,68712844
Thailand,THA,2012,31428409,37728616,69157025
Thailand,THA,2013,32140444,37438160,69578604
Thailand,THA,2014,32841765,37119176,69960941
Thailand,THA,2015,33526210,36768188,70294398
Thailand,THA,2016,34207697,36399340,70607037
Thailand,THA,2017,34881915,36016290,70898205
Thailand,THA,2018,35527626,35600176,71127802
Thailand,THA,2019,36147331,35160430,71307761
Thailand,THA,2020,36759934,34715730,71475664
Thailand,THA,2021,37349283,34251820,71601103
Togo,TGO,1960,166755,1484612,1651367
Togo,TGO,1961,183659,1495129,1678788
Togo,TGO,1962,202158,1504683,1706841
Togo,TGO,1963,222488,1514209,1736697
Togo,TGO,1964,245459,1527193,1772652
Togo,TGO,1965,272149,1548247,1820396
Togo,TGO,1966,303546,1578912,1882458
Togo,TGO,1967,340038,1617126,1957164
Togo,TGO,1968,381249,1657516,2038765
Togo,TGO,1969,426175,1694311,2120486
Togo,TGO,1970,467603,1729780,2197383
Togo,TGO,1971,489763,1777448,2267211
Togo,TGO,1972,511100,1819604,2330704
Togo,TGO,1973,532169,1858740,2390909
Togo,TGO,1974,553555,1896780,2450335
Togo,TGO,1975,575402,1934311,2509713
Togo,TGO,1976,597911,1971760,2569671
Togo,TGO,1977,621117,2009509,2630626
Togo,TGO,1978,645285,2048115,2693400
Togo,TGO,1979,671202,2090038,2761240
Togo,TGO,1980,699963,2138147,2838110
Togo,TGO,1981,732051,2193814,2925865
Togo,TGO,1982,767657,2255686,3023343
Togo,TGO,1983,805984,2320651,3126635
Togo,TGO,1984,845846,2386398,3232244
Togo,TGO,1985,886243,2450265,3336508
Togo,TGO,1986,927254,2512116,3439370
Togo,TGO,1987,969963,2574964,3544927
Togo,TGO,1988,1014482,2638938,3653420
Togo,TGO,1989,1060448,2703209,3763657
Togo,TGO,1990,1108094,2767853,3875947
Togo,TGO,1991,1157362,2832853,3990215
Togo,TGO,1992,1208255,2897964,4106219
Togo,TGO,1993,1217318,2861074,4078392
Togo,TGO,1994,1239038,2853574,4092612
Togo,TGO,1995,1314041,2965525,4279566
Togo,TGO,1996,1384404,3061479,4445883
Togo,TGO,1997,1450144,3142406,4592550
Togo,TGO,1998,1513812,3214485,4728297
Togo,TGO,1999,1580134,3287807,4867941
Togo,TGO,2000,1647994,3360041,5008035
Togo,TGO,2001,1716308,3429118,5145426
Togo,TGO,2002,1785635,3495903,5281538
Togo,TGO,2003,1857506,3563495,5421001
Togo,TGO,2004,1932466,3632752,5565218
Togo,TGO,2005,2009625,3701972,5711597
Togo,TGO,2006,2094108,3780132,5874240
Togo,TGO,2007,2184128,3863409,6047537
Togo,TGO,2008,2276619,3945863,6222482
Togo,TGO,2009,2371202,4027422,6398624
Togo,TGO,2010,2466614,4105241,6571855
Togo,TGO,2011,2566655,4182017,6748672
Togo,TGO,2012,2669941,4256694,6926635
Togo,TGO,2013,2775764,4330465,7106229
Togo,TGO,2014,2884669,4403714,7288383
Togo,TGO,2015,2996765,4476464,7473229
Togo,TGO,2016,3112655,4548699,7661354
Togo,TGO,2017,3232367,4620428,7852795
Togo,TGO,2018,3355626,4691053,8046679
Togo,TGO,2019,3482542,4760552,8243094
Togo,TGO,2020,3613424,4829156,8442580
Togo,TGO,2021,3748225,4896604,8644829
Tonga,TON,1960,11835,55593,67428
Tonga,TON,1961,12441,56950,69391
Tonga,TON,1962,13073,58315,71388
Tonga,TON,1963,13734,59707,73441
Tonga,TON,1964,14427,61117,75544
Tonga,TON,1965,15148,62538,77686
Tonga,TON,1966,15885,63909,79794
Tonga,TON,1967,16424,65301,81725
Tonga,TON,1968,16792,66638,83430
Tonga,TON,1969,17133,67864,84997
Tonga,TON,1970,17459,69025,86484
Tonga,TON,1971,17772,70132,87904
Tonga,TON,1972,18076,71199,89275
Tonga,TON,1973,18373,72238,90611
Tonga,TON,1974,18684,73323,92007
Tonga,TON,1975,19010,74467,93477
Tonga,TON,1976,19333,75588,94921
Tonga,TON,1977,19652,76195,95847
Tonga,TON,1978,19937,76290,96227
Tonga,TON,1979,20204,76302,96506
Tonga,TON,1980,20458,76250,96708
Tonga,TON,1981,20699,76147,96846
Tonga,TON,1982,20931,76000,96931
Tonga,TON,1983,21158,75823,96981
Tonga,TON,1984,21386,75636,97022
Tonga,TON,1985,21612,75443,97055
Tonga,TON,1986,21839,75239,97078
Tonga,TON,1987,22019,75373,97392
Tonga,TON,1988,22174,75765,97939
Tonga,TON,1989,22304,76075,98379
Tonga,TON,1990,22415,76312,98727
Tonga,TON,1991,22511,76499,99010
Tonga,TON,1992,22600,76660,99260
Tonga,TON,1993,22684,76808,99492
Tonga,TON,1994,22771,76960,99731
Tonga,TON,1995,22859,77118,99977
Tonga,TON,1996,22942,77253,100195
Tonga,TON,1997,23078,77580,100658
Tonga,TON,1998,23263,78080,101343
Tonga,TON,1999,23440,78542,101982
Tonga,TON,2000,23611,78992,102603
Tonga,TON,2001,23781,79429,103210
Tonga,TON,2002,23947,79857,103804
Tonga,TON,2003,24117,80293,104410
Tonga,TON,2004,24292,80744,105036
Tonga,TON,2005,24459,81174,105633
Tonga,TON,2006,24619,81571,106190
Tonga,TON,2007,24769,81869,106638
Tonga,TON,2008,24895,82037,106932
Tonga,TON,2009,25002,82142,107144
Tonga,TON,2010,25116,82267,107383
Tonga,TON,2011,25227,82384,107611
Tonga,TON,2012,25193,82309,107502
Tonga,TON,2013,25040,82049,107089
Tonga,TON,2014,24874,81752,106626
Tonga,TON,2015,24700,81422,106122
Tonga,TON,2016,24547,81160,105707
Tonga,TON,2017,24424,80991,105415
Tonga,TON,2018,24322,80828,105150
Tonga,TON,2019,24251,80700,104951
Tonga,TON,2020,24313,80941,105254
Tonga,TON,2021,24494,81523,106017
Trinidad and Tobago,TTO,1960,289314,557749,847063
Trinidad and Tobago,TTO,1961,302794,562234,865028
Trinidad and Tobago,TTO,1962,316148,565371,881519
Trinidad and Tobago,TTO,1963,329746,567912,897658
Trinidad and Tobago,TTO,1964,343557,569842,913399
Trinidad and Tobago,TTO,1965,357439,571023,928462
Trinidad and Tobago,TTO,1966,371309,571290,942599
Trinidad and Tobago,TTO,1967,385082,570599,955681
Trinidad and Tobago,TTO,1968,398721,568978,967699
Trinidad and Tobago,TTO,1969,412155,566487,978642
Trinidad and Tobago,TTO,1970,425569,563321,988890
Trinidad and Tobago,TTO,1971,439647,560483,1000130
Trinidad and Tobago,TTO,1972,454729,558302,1013031
Trinidad and Tobago,TTO,1973,470361,556202,1026563
Trinidad and Tobago,TTO,1974,486378,553913,1040291
Trinidad and Tobago,TTO,1975,502671,551346,1054017
Trinidad and Tobago,TTO,1976,519231,548465,1067696
Trinidad and Tobago,TTO,1977,536195,545498,1081693
Trinidad and Tobago,TTO,1978,553877,542692,1096569
Trinidad and Tobago,TTO,1979,572272,540038,1112310
Trinidad and Tobago,TTO,1980,589686,538166,1127852
Trinidad and Tobago,TTO,1981,599549,543146,1142695
Trinidad and Tobago,TTO,1982,609269,547871,1157140
Trinidad and Tobago,TTO,1983,618866,552407,1171273
Trinidad and Tobago,TTO,1984,628165,556582,1184747
Trinidad and Tobago,TTO,1985,638346,561439,1199785
Trinidad and Tobago,TTO,1986,649408,566962,1216370
Trinidad and Tobago,TTO,1987,659720,571722,1231442
Trinidad and Tobago,TTO,1988,669077,575556,1244633
Trinidad and Tobago,TTO,1989,677612,578598,1256210
Trinidad and Tobago,TTO,1990,685490,581028,1266518
Trinidad and Tobago,TTO,1991,693092,583132,1276224
Trinidad and Tobago,TTO,1992,700483,585019,1285502
Trinidad and Tobago,TTO,1993,707467,586507,1293974
Trinidad and Tobago,TTO,1994,713905,587488,1301393
Trinidad and Tobago,TTO,1995,719825,587997,1307822
Trinidad and Tobago,TTO,1996,725331,588103,1313434
Trinidad and Tobago,TTO,1997,730346,587825,1318171
Trinidad and Tobago,TTO,1998,735205,587367,1322572
Trinidad and Tobago,TTO,1999,740116,586947,1327063
Trinidad and Tobago,TTO,2000,744768,587435,1332203
Trinidad and Tobago,TTO,2001,745823,592744,1338567
Trinidad and Tobago,TTO,2002,747414,598550,1345964
Trinidad and Tobago,TTO,2003,749094,604454,1353548
Trinidad and Tobago,TTO,2004,750754,610418,1361172
Trinidad and Tobago,TTO,2005,752539,616536,1369075
Trinidad and Tobago,TTO,2006,754262,622657,1376919
Trinidad and Tobago,TTO,2007,755996,628865,1384861
Trinidad and Tobago,TTO,2008,757713,635090,1392803
Trinidad and Tobago,TTO,2009,759628,641563,1401191
Trinidad and Tobago,TTO,2010,761912,648384,1410296
Trinidad and Tobago,TTO,2011,764482,655538,1420020
Trinidad and Tobago,TTO,2012,767698,662679,1430377
Trinidad and Tobago,TTO,2013,771222,669507,1440729
Trinidad and Tobago,TTO,2014,774842,675819,1450661
Trinidad and Tobago,TTO,2015,778552,681625,1460177
Trinidad and Tobago,TTO,2016,782418,686912,1469330
Trinidad and Tobago,TTO,2017,786693,691914,1478607
Trinidad and Tobago,TTO,2018,800264,704445,1504709
Trinidad and Tobago,TTO,2019,808418,711537,1519955
Trinidad and Tobago,TTO,2020,807867,710280,1518147
Trinidad and Tobago,TTO,2021,812644,713019,1525663
Tunisia,TUN,1960,1573762,2621705,4195467
Tunisia,TUN,1961,1607708,2628678,4236386
Tunisia,TUN,1962,1643804,2637940,4281744
Tunisia,TUN,1963,1682605,2650321,4332926
Tunisia,TUN,1964,1724119,2665298,4389417
Tunisia,TUN,1965,1770611,2686671,4457282
Tunisia,TUN,1966,1830051,2718921,4548972
Tunisia,TUN,1967,1912799,2748472,4661271
Tunisia,TUN,1968,2002428,2782575,4785003
Tunisia,TUN,1969,2096906,2818256,4915162
Tunisia,TUN,1970,2194712,2852692,5047404
Tunisia,TUN,1971,2295903,2886137,5182040
Tunisia,TUN,1972,2401089,2919059,5320148
Tunisia,TUN,1973,2511039,2952611,5463650
Tunisia,TUN,1974,2626377,2986739,5613116
Tunisia,TUN,1975,2745387,3023687,5769074
Tunisia,TUN,1976,2857310,3072688,5929998
Tunisia,TUN,1977,2971992,3120777,6092769
Tunisia,TUN,1978,3088345,3166531,6254876
Tunisia,TUN,1979,3206299,3209892,6416191
Tunisia,TUN,1980,3326508,3251648,6578156
Tunisia,TUN,1981,3450526,3293524,6744050
Tunisia,TUN,1982,3579185,3335778,6914963
Tunisia,TUN,1983,3712705,3378565,7091270
Tunisia,TUN,1984,3858754,3420403,7279157
Tunisia,TUN,1985,4025053,3451039,7476092
Tunisia,TUN,1986,4195965,3479534,7675499
Tunisia,TUN,1987,4369529,3504773,7874302
Tunisia,TUN,1988,4543857,3524931,8068788
Tunisia,TUN,1989,4716962,3539434,8256396
Tunisia,TUN,1990,4890656,3549367,8440023
Tunisia,TUN,1991,5066444,3556409,8622853
Tunisia,TUN,1992,5242969,3559571,8802540
Tunisia,TUN,1993,5418801,3558372,8977173
Tunisia,TUN,1994,5584448,3558693,9143141
Tunisia,TUN,1995,5713456,3580646,9294102
Tunisia,TUN,1996,5834681,3595869,9430550
Tunisia,TUN,1997,5950970,3606978,9557948
Tunisia,TUN,1998,6063024,3614124,9677148
Tunisia,TUN,1999,6170691,3617376,9788067
Tunisia,TUN,2000,6275528,3617788,9893316
Tunisia,TUN,2001,6378688,3616435,9995123
Tunisia,TUN,2002,6480910,3613651,10094561
Tunisia,TUN,2003,6583664,3610134,10193798
Tunisia,TUN,2004,6684800,3607425,10292225
Tunisia,TUN,2005,6777044,3611300,10388344
Tunisia,TUN,2006,6869247,3614311,10483558
Tunisia,TUN,2007,6962852,3617543,10580395
Tunisia,TUN,2008,7058984,3621396,10680380
Tunisia,TUN,2009,7158322,3626182,10784504
Tunisia,TUN,2010,7262322,3632741,10895063
Tunisia,TUN,2011,7384954,3647574,11032528
Tunisia,TUN,2012,7511197,3663186,11174383
Tunisia,TUN,2013,7627127,3673157,11300284
Tunisia,TUN,2014,7745627,3683321,11428948
Tunisia,TUN,2015,7865762,3692017,11557779
Tunisia,TUN,2016,7986686,3698981,11685667
Tunisia,TUN,2017,8107611,3703832,11811443
Tunisia,TUN,2018,8227235,3705806,11933041
Tunisia,TUN,2019,8344632,3704682,12049314
Tunisia,TUN,2020,8460667,3701056,12161723
Tunisia,TUN,2021,8570328,3692618,12262946
Turkey,TUR,1960,8670085,18840896,27510981
Turkey,TUR,1961,9059684,19195318,28255002
Turkey,TUR,1962,9464388,19569260,29033648
Turkey,TUR,1963,9884064,19943812,29827876
Turkey,TUR,1964,10310398,20302424,30612822
Turkey,TUR,1965,10738562,20635974,31374536
Turkey,TUR,1966,11244067,20928718,32172785
Turkey,TUR,1967,11809943,21216548,33026491
Turkey,TUR,1968,12393778,21490296,33884074
Turkey,TUR,1969,12986371,21735620,34721991
Turkey,TUR,1970,13588742,21952248,35540990
Turkey,TUR,1971,14160385,22199572,36359957
Turkey,TUR,1972,14726462,22461572,37188034
Turkey,TUR,1973,15309407,22718828,38028235
Turkey,TUR,1974,15902911,22960508,38863419
Turkey,TUR,1975,16498659,23174932,39673591
Turkey,TUR,1976,17045655,23455342,40500997
Turkey,TUR,1977,17592215,23793440,41385655
Turkey,TUR,1978,18156467,24135740,42292207
Turkey,TUR,1979,18723930,24463546,43187476
Turkey,TUR,1980,19302194,24786876,44089070
Turkey,TUR,1981,20326860,24655016,44981876
Turkey,TUR,1982,21595117,24354874,45949991
Turkey,TUR,1983,22954539,24071886,47026425
Turkey,TUR,1984,24358379,23748384,48106763
Turkey,TUR,1985,25791657,23384016,49175673
Turkey,TUR,1986,27085741,23138144,50223885
Turkey,TUR,1987,28321346,22928806,51250152
Turkey,TUR,1988,29581358,22694532,52275890
Turkey,TUR,1989,30863197,22442036,53305233
Turkey,TUR,1990,32161522,22162620,54324142
Turkey,TUR,1991,33179426,22141746,55321172
Turkey,TUR,1992,34072867,22229170,56302037
Turkey,TUR,1993,34982078,22313930,57296008
Turkey,TUR,1994,35913280,22396964,58310244
Turkey,TUR,1995,36842350,22463140,59305490
Turkey,TUR,1996,37775866,22517920,60293786
Turkey,TUR,1997,38714465,22562960,61277425
Turkey,TUR,1998,39650151,22592052,62242203
Turkey,TUR,1999,40579698,22605916,63185614
Turkey,TUR,2000,41507751,22605796,64113547
Turkey,TUR,2001,42518057,22553960,65072017
Turkey,TUR,2002,43535361,22453302,65988663
Turkey,TUR,2003,44534977,22332350,66867327
Turkey,TUR,2004,45568517,22216558,67785075
Turkey,TUR,2005,46609279,22095436,68704715
Turkey,TUR,2006,47642112,21959220,69601332
Turkey,TUR,2007,48660868,21808000,70468868
Turkey,TUR,2008,49675599,21645128,71320727
Turkey,TUR,2009,50732011,21493628,72225639
Turkey,TUR,2010,51840603,21354742,73195345
Turkey,TUR,2011,52961615,21212240,74173855
Turkey,TUR,2012,54180184,21097256,75277440
Turkey,TUR,2013,55541423,21034694,76576117
Turkey,TUR,2014,57081960,21030112,78112072
Turkey,TUR,2015,58628348,21017830,79646178
Turkey,TUR,2016,60062918,20956476,81019394
Turkey,TUR,2017,61275130,20814696,82089826
Turkey,TUR,2018,62225395,20583908,82809303
Turkey,TUR,2019,63137198,20344486,83481684
Turkey,TUR,2020,64031267,20104160,84135427
Turkey,TUR,2021,64911679,19863724,84775403
Turkmenistan,TKM,1960,743544,858508,1602052
Turkmenistan,TKM,1961,772180,886389,1658569
Turkmenistan,TKM,1962,801812,915056,1716868
Turkmenistan,TKM,1963,832202,944185,1776387
Turkmenistan,TKM,1964,863083,973538,1836621
Turkmenistan,TKM,1965,894272,1002823,1897095
Turkmenistan,TKM,1966,925611,1031946,1957557
Turkmenistan,TKM,1967,957149,1060875,2018024
Turkmenistan,TKM,1968,988885,1089696,2078581
Turkmenistan,TKM,1969,1021018,1118539,2139557
Turkmenistan,TKM,1970,1051844,1149588,2201432
Turkmenistan,TKM,1971,1080928,1183506,2264434
Turkmenistan,TKM,1972,1110425,1217949,2328374
Turkmenistan,TKM,1973,1140323,1253000,2393323
Turkmenistan,TKM,1974,1170688,1288637,2459325
Turkmenistan,TKM,1975,1201176,1324584,2525760
Turkmenistan,TKM,1976,1231670,1360610,2592280
Turkmenistan,TKM,1977,1262210,1396809,2659019
Turkmenistan,TKM,1978,1292933,1433394,2726327
Turkmenistan,TKM,1979,1321719,1472673,2794392
Turkmenistan,TKM,1980,1347797,1515106,2862903
Turkmenistan,TKM,1981,1374314,1558620,2932934
Turkmenistan,TKM,1982,1401895,1604077,3005972
Turkmenistan,TKM,1983,1430666,1651536,3082202
Turkmenistan,TKM,1984,1460794,1701371,3162165
Turkmenistan,TKM,1985,1492789,1754098,3246887
Turkmenistan,TKM,1986,1526807,1809966,3336773
Turkmenistan,TKM,1987,1562147,1868354,3430501
Turkmenistan,TKM,1988,1597474,1927636,3525110
Turkmenistan,TKM,1989,1635380,1985923,3621303
Turkmenistan,TKM,1990,1676915,2043363,3720278
Turkmenistan,TKM,1991,1719420,2102362,3821782
Turkmenistan,TKM,1992,1763097,2163272,3926369
Turkmenistan,TKM,1993,1806967,2224731,4031698
Turkmenistan,TKM,1994,1848873,2284164,4133037
Turkmenistan,TKM,1995,1893274,2333349,4226623
Turkmenistan,TKM,1996,1936266,2364827,4301093
Turkmenistan,TKM,1997,1974169,2389503,4363672
Turkmenistan,TKM,1998,2014789,2416728,4431517
Turkmenistan,TKM,1999,2056498,2444581,4501079
Turkmenistan,TKM,2000,2097826,2471306,4569132
Turkmenistan,TKM,2001,2138493,2496601,4635094
Turkmenistan,TKM,2002,2178536,2520432,4698968
Turkmenistan,TKM,2003,2217070,2541918,4758988
Turkmenistan,TKM,2004,2256241,2563551,4819792
Turkmenistan,TKM,2005,2298855,2586920,4885775
Turkmenistan,TKM,2006,2343652,2610377,4954029
Turkmenistan,TKM,2007,2390895,2633999,5024894
Turkmenistan,TKM,2008,2441308,2658775,5100083
Turkmenistan,TKM,2009,2495771,2685186,5180957
Turkmenistan,TKM,2010,2554491,2713479,5267970
Turkmenistan,TKM,2011,2617416,2743395,5360811
Turkmenistan,TKM,2012,2684307,2774375,5458682
Turkmenistan,TKM,2013,2754527,2805568,5560095
Turkmenistan,TKM,2014,2827102,2836050,5663152
Turkmenistan,TKM,2015,2901495,2864936,5766431
Turkmenistan,TKM,2016,2977004,2891557,5868561
Turkmenistan,TKM,2017,3053007,2915376,5968383
Turkmenistan,TKM,2018,3129150,2935916,6065066
Turkmenistan,TKM,2019,3205334,2953086,6158420
Turkmenistan,TKM,2020,3282480,2967958,6250438
Turkmenistan,TKM,2021,3361056,2980799,6341855
Turks and Caicos Islands,TCA,1960,2672,2932,5604
Turks and Caicos Islands,TCA,1961,2701,2924,5625
Turks and Caicos Islands,TCA,1962,2724,2909,5633
Turks and Caicos Islands,TCA,1963,2744,2890,5634
Turks and Caicos Islands,TCA,1964,2767,2875,5642
Turks and Caicos Islands,TCA,1965,2791,2859,5650
Turks and Caicos Islands,TCA,1966,2811,2841,5652
Turks and Caicos Islands,TCA,1967,2835,2827,5662
Turks and Caicos Islands,TCA,1968,2858,2810,5668
Turks and Caicos Islands,TCA,1969,2875,2788,5663
Turks and Caicos Islands,TCA,1970,2895,2770,5665
Turks and Caicos Islands,TCA,1971,2956,2786,5742
Turks and Caicos Islands,TCA,1972,3059,2837,5896
Turks and Caicos Islands,TCA,1973,3172,2896,6068
Turks and Caicos Islands,TCA,1974,3291,2958,6249
Turks and Caicos Islands,TCA,1975,3423,3028,6451
Turks and Caicos Islands,TCA,1976,3564,3104,6668
Turks and Caicos Islands,TCA,1977,3707,3178,6885
Turks and Caicos Islands,TCA,1978,3856,3254,7110
Turks and Caicos Islands,TCA,1979,4006,3326,7332
Turks and Caicos Islands,TCA,1980,4199,3399,7598
Turks and Caicos Islands,TCA,1981,4564,3393,7957
Turks and Caicos Islands,TCA,1982,4966,3389,8355
Turks and Caicos Islands,TCA,1983,5384,3374,8758
Turks and Caicos Islands,TCA,1984,5819,3347,9166
Turks and Caicos Islands,TCA,1985,6267,3310,9577
Turks and Caicos Islands,TCA,1986,6725,3261,9986
Turks and Caicos Islands,TCA,1987,7196,3204,10400
Turks and Caicos Islands,TCA,1988,7678,3138,10816
Turks and Caicos Islands,TCA,1989,8164,3063,11227
Turks and Caicos Islands,TCA,1990,8705,3004,11709
Turks and Caicos Islands,TCA,1991,9313,3016,12329
Turks and Caicos Islands,TCA,1992,9981,3033,13014
Turks and Caicos Islands,TCA,1993,10663,3041,13704
Turks and Caicos Islands,TCA,1994,11361,3041,14402
Turks and Caicos Islands,TCA,1995,12070,3031,15101
Turks and Caicos Islands,TCA,1996,12792,3014,15806
Turks and Caicos Islands,TCA,1997,13524,2991,16515
Turks and Caicos Islands,TCA,1998,14276,2963,17239
Turks and Caicos Islands,TCA,1999,15053,2931,17984
Turks and Caicos Islands,TCA,2000,15848,2896,18744
Turks and Caicos Islands,TCA,2001,16712,2866,19578
Turks and Caicos Islands,TCA,2002,17716,2882,20598
Turks and Caicos Islands,TCA,2003,18828,2911,21739
Turks and Caicos Islands,TCA,2004,19939,2930,22869
Turks and Caicos Islands,TCA,2005,21054,2941,23995
Turks and Caicos Islands,TCA,2006,22183,2945,25128
Turks and Caicos Islands,TCA,2007,23325,2943,26268
Turks and Caicos Islands,TCA,2008,24486,2936,27422
Turks and Caicos Islands,TCA,2009,25657,2924,28581
Turks and Caicos Islands,TCA,2010,26821,2905,29726
Turks and Caicos Islands,TCA,2011,27940,2876,30816
Turks and Caicos Islands,TCA,2012,29223,2858,32081
Turks and Caicos Islands,TCA,2013,30733,2861,33594
Turks and Caicos Islands,TCA,2014,32134,2851,34985
Turks and Caicos Islands,TCA,2015,33686,2852,36538
Turks and Caicos Islands,TCA,2016,35384,2862,38246
Turks and Caicos Islands,TCA,2017,36982,2862,39844
Turks and Caicos Islands,TCA,2018,38624,2863,41487
Turks and Caicos Islands,TCA,2019,40219,2861,43080
Turks and Caicos Islands,TCA,2020,41445,2831,44276
Turks and Caicos Islands,TCA,2021,42332,2782,45114
Tuvalu,TUV,1960,859,4545,5404
Tuvalu,TUV,1961,894,4542,5436
Tuvalu,TUV,1962,931,4540,5471
Tuvalu,TUV,1963,968,4535,5503
Tuvalu,TUV,1964,1005,4520,5525
Tuvalu,TUV,1965,1043,4505,5548
Tuvalu,TUV,1966,1086,4505,5591
Tuvalu,TUV,1967,1135,4522,5657
Tuvalu,TUV,1968,1187,4542,5729
Tuvalu,TUV,1969,1236,4543,5779
Tuvalu,TUV,1970,1284,4530,5814
Tuvalu,TUV,1971,1334,4520,5854
Tuvalu,TUV,1972,1385,4506,5891
Tuvalu,TUV,1973,1439,4495,5934
Tuvalu,TUV,1974,1525,4575,6100
Tuvalu,TUV,1975,1644,4737,6381
Tuvalu,TUV,1976,1772,4905,6677
Tuvalu,TUV,1977,1909,5075,6984
Tuvalu,TUV,1978,2054,5243,7297
Tuvalu,TUV,1979,2189,5363,7552
Tuvalu,TUV,1980,2306,5425,7731
Tuvalu,TUV,1981,2415,5459,7874
Tuvalu,TUV,1982,2521,5472,7993
Tuvalu,TUV,1983,2626,5473,8099
Tuvalu,TUV,1984,2731,5466,8197
Tuvalu,TUV,1985,2853,5476,8329
Tuvalu,TUV,1986,3016,5480,8496
Tuvalu,TUV,1987,3185,5480,8665
Tuvalu,TUV,1988,3365,5479,8844
Tuvalu,TUV,1989,3548,5469,9017
Tuvalu,TUV,1990,3733,5449,9182
Tuvalu,TUV,1991,3928,5426,9354
Tuvalu,TUV,1992,4047,5419,9466
Tuvalu,TUV,1993,4107,5410,9517
Tuvalu,TUV,1994,4164,5395,9559
Tuvalu,TUV,1995,4215,5370,9585
Tuvalu,TUV,1996,4265,5346,9611
Tuvalu,TUV,1997,4313,5317,9630
Tuvalu,TUV,1998,4354,5280,9634
Tuvalu,TUV,1999,4397,5243,9640
Tuvalu,TUV,2000,4435,5203,9638
Tuvalu,TUV,2001,4467,5154,9621
Tuvalu,TUV,2002,4501,5108,9609
Tuvalu,TUV,2003,4607,5061,9668
Tuvalu,TUV,2004,4766,5025,9791
Tuvalu,TUV,2005,4926,4986,9912
Tuvalu,TUV,2006,5087,4943,10030
Tuvalu,TUV,2007,5251,4898,10149
Tuvalu,TUV,2008,5420,4852,10272
Tuvalu,TUV,2009,5598,4810,10408
Tuvalu,TUV,2010,5781,4769,10550
Tuvalu,TUV,2011,5971,4729,10700
Tuvalu,TUV,2012,6167,4687,10854
Tuvalu,TUV,2013,6312,4606,10918
Tuvalu,TUV,2014,6407,4492,10899
Tuvalu,TUV,2015,6497,4380,10877
Tuvalu,TUV,2016,6581,4271,10852
Tuvalu,TUV,2017,6662,4166,10828
Tuvalu,TUV,2018,6778,4087,10865
Tuvalu,TUV,2019,6926,4030,10956
Tuvalu,TUV,2020,7086,3983,11069
Tuvalu,TUV,2021,7259,3945,11204
Uganda,UGA,1960,336476,7281270,7617746
Uganda,UGA,1961,361901,7476539,7838440
Uganda,UGA,1962,389402,7679426,8068828
Uganda,UGA,1963,419291,7891722,8311013
Uganda,UGA,1964,451620,8113135,8564755
Uganda,UGA,1965,486393,8342663,8829056
Uganda,UGA,1966,524160,8580583,9104743
Uganda,UGA,1967,564921,8828511,9393432
Uganda,UGA,1968,609223,9087147,9696370
Uganda,UGA,1969,656628,9349898,10006526
Uganda,UGA,1970,687539,9629673,10317212
Uganda,UGA,1971,715223,9901115,10616338
Uganda,UGA,1972,741525,10144038,10885563
Uganda,UGA,1973,767632,10378467,11146099
Uganda,UGA,1974,795779,10632897,11428676
Uganda,UGA,1975,825860,10905099,11730959
Uganda,UGA,1976,857379,11187848,12045227
Uganda,UGA,1977,890215,11479038,12369253
Uganda,UGA,1978,924197,11777802,12701999
Uganda,UGA,1979,957127,12054384,13011511
Uganda,UGA,1980,1000819,12283207,13284026
Uganda,UGA,1981,1062569,12500989,13563558
Uganda,UGA,1982,1130808,12749244,13880052
Uganda,UGA,1983,1205191,13023741,14228932
Uganda,UGA,1984,1287110,13330834,14617944
Uganda,UGA,1985,1376362,13662553,15038915
Uganda,UGA,1986,1472950,14013857,15486807
Uganda,UGA,1987,1578572,14395644,15974216
Uganda,UGA,1988,1692959,14796364,16489323
Uganda,UGA,1989,1816094,15212449,17028543
Uganda,UGA,1990,1947895,15638735,17586630
Uganda,UGA,1991,2081413,16090522,18171935
Uganda,UGA,1992,2216752,16585214,18801966
Uganda,UGA,1993,2361441,17101516,19462957
Uganda,UGA,1994,2512609,17612412,20125021
Uganda,UGA,1995,2656660,18024172,20680832
Uganda,UGA,1996,2808343,18441228,21249571
Uganda,UGA,1997,2973951,18902984,21876935
Uganda,UGA,1998,3151215,19386444,22537659
Uganda,UGA,1999,3347323,19931924,23279247
Uganda,UGA,2000,3551700,20468996,24020696
Uganda,UGA,2001,3764273,20999052,24763325
Uganda,UGA,2002,3991676,21553414,25545090
Uganda,UGA,2003,4232834,22121902,26354736
Uganda,UGA,2004,4481004,22665080,27146084
Uganda,UGA,2005,4739741,23206848,27946589
Uganda,UGA,2006,5013735,23759492,28773227
Uganda,UGA,2007,5303439,24326364,29629803
Uganda,UGA,2008,5608933,24900928,30509861
Uganda,UGA,2009,5930056,25482464,31412520
Uganda,UGA,2010,6268797,26072932,32341729
Uganda,UGA,2011,6625186,26670552,33295738
Uganda,UGA,2012,6999978,27273316,34273294
Uganda,UGA,2013,7392635,27880936,35273571
Uganda,UGA,2014,7813809,28522730,36336539
Uganda,UGA,2015,8267505,29209852,37477357
Uganda,UGA,2016,8766415,29981884,38748299
Uganda,UGA,2017,9307879,30819206,40127085
Uganda,UGA,2018,9869870,31645524,41515394
Uganda,UGA,2019,10462825,32486256,42949081
Uganda,UGA,2020,11080727,33323884,44404611
Uganda,UGA,2021,11717016,34136760,45853776
Ukraine,UKR,1960,20011652,22755600,42767252
Ukraine,UKR,1961,20616692,22748528,43365220
Ukraine,UKR,1962,21213021,22711734,43924755
Ukraine,UKR,1963,21798938,22646964,44445902
Ukraine,UKR,1964,22380820,22560586,44941406
Ukraine,UKR,1965,22988108,22398984,45387092
Ukraine,UKR,1966,23591239,22217880,45809119
Ukraine,UKR,1967,24203291,22032080,46235371
Ukraine,UKR,1968,24808525,21826672,46635197
Ukraine,UKR,1969,25394816,21596072,46990888
Ukraine,UKR,1970,25923596,21355490,47279086
Ukraine,UKR,1971,26441505,21156252,47597757
Ukraine,UKR,1972,26996035,20978152,47974187
Ukraine,UKR,1973,27525603,20775944,48301547
Ukraine,UKR,1974,28043754,20558940,48602694
Ukraine,UKR,1975,28547659,20344528,48892187
Ukraine,UKR,1976,29032134,20112400,49144534
Ukraine,UKR,1977,29494026,19863404,49357430
Ukraine,UKR,1978,29936958,19599656,49536614
Ukraine,UKR,1979,30381527,19358208,49739735
Ukraine,UKR,1980,30830410,19143510,49973920
Ukraine,UKR,1981,31287683,18933316,50220999
Ukraine,UKR,1982,31693551,18690448,50383999
Ukraine,UKR,1983,32110163,18453836,50563999
Ukraine,UKR,1984,32533314,18220686,50754000
Ukraine,UKR,1985,32933625,17983376,50917001
Ukraine,UKR,1986,33344880,17752120,51097000
Ukraine,UKR,1987,33766182,17526818,51293000
Ukraine,UKR,1988,34209429,17311572,51521001
Ukraine,UKR,1989,34541910,17231090,51773000
Ukraine,UKR,1990,34641142,17250258,51891400
Ukraine,UKR,1991,34734254,17266246,52000500
Ukraine,UKR,1992,34854720,17295680,52150400
Ukraine,UKR,1993,34894318,17284882,52179200
Ukraine,UKR,1994,34741647,17179752,51921399
Ukraine,UKR,1995,34488335,17024464,51512799
Ukraine,UKR,1996,34203620,16854180,51057800
Ukraine,UKR,1997,33913054,16681546,50594600
Ukraine,UKR,1998,33630412,16514088,50144500
Ukraine,UKR,1999,33334234,16339766,49674000
Ukraine,UKR,2000,33019561,16156939,49176500
Ukraine,UKR,2001,32692860,15969540,48662400
Ukraine,UKR,2002,32432068,15770402,48202470
Ukraine,UKR,2003,32238837,15574112,47812949
Ukraine,UKR,2004,32075876,15375750,47451626
Ukraine,UKR,2005,31932595,15172576,47105171
Ukraine,UKR,2006,31801190,14986596,46787786
Ukraine,UKR,2007,31694730,14814625,46509355
Ukraine,UKR,2008,31605908,14652281,46258189
Ukraine,UKR,2009,31547453,14505878,46053331
Ukraine,UKR,2010,31465493,14405248,45870741
Ukraine,UKR,2011,31395053,14311033,45706086
Ukraine,UKR,2012,31360012,14233330,45593342
Ukraine,UKR,2013,31330995,14158653,45489648
Ukraine,UKR,2014,31223300,14048855,45272155
Ukraine,UKR,2015,31183829,13970207,45154036
Ukraine,UKR,2016,31122532,13882141,45004673
Ukraine,UKR,2017,31043768,13787367,44831135
Ukraine,UKR,2018,30946609,13675909,44622518
Ukraine,UKR,2019,30836427,13549776,44386203
Ukraine,UKR,2020,30719437,13412612,44132049
Ukraine,UKR,2021,30548582,13244273,43792855
United Arab Emirates,ARE,1960,98068,35358,133426
United Arab Emirates,ARE,1961,104868,36116,140984
United Arab Emirates,ARE,1962,112027,36850,148877
United Arab Emirates,ARE,1963,119471,37535,157006
United Arab Emirates,ARE,1964,127151,38154,165305
United Arab Emirates,ARE,1965,135080,38717,173797
United Arab Emirates,ARE,1966,143284,39225,182509
United Arab Emirates,ARE,1967,151730,39674,191404
United Arab Emirates,ARE,1968,170438,43144,213582
United Arab Emirates,ARE,1969,202102,51159,253261
United Arab Emirates,ARE,1970,237871,60213,298084
United Arab Emirates,ARE,1971,274921,69592,344513
United Arab Emirates,ARE,1972,313110,79258,392368
United Arab Emirates,ARE,1973,352354,89192,441546
United Arab Emirates,ARE,1974,392580,99375,491955
United Arab Emirates,ARE,1975,433628,109766,543394
United Arab Emirates,ARE,1976,490746,123431,614177
United Arab Emirates,ARE,1977,566238,140623,706861
United Arab Emirates,ARE,1978,646673,158558,805231
United Arab Emirates,ARE,1979,731395,177057,908452
United Arab Emirates,ARE,1980,818438,195610,1014048
United Arab Emirates,ARE,1981,887658,212522,1100180
United Arab Emirates,ARE,1982,939727,228129,1167856
United Arab Emirates,ARE,1983,993114,244458,1237572
United Arab Emirates,ARE,1984,1047005,261326,1308331
United Arab Emirates,ARE,1985,1100925,278611,1379536
United Arab Emirates,ARE,1986,1169435,299262,1468697
United Arab Emirates,ARE,1987,1252564,323345,1575909
United Arab Emirates,ARE,1988,1335816,347865,1683681
United Arab Emirates,ARE,1989,1419066,372774,1791840
United Arab Emirates,ARE,1990,1502088,398063,1900151
United Arab Emirates,ARE,1991,1584735,423648,2008383
United Arab Emirates,ARE,1992,1666744,449487,2116231
United Arab Emirates,ARE,1993,1747812,475472,2223284
United Arab Emirates,ARE,1994,1827515,501509,2329024
United Arab Emirates,ARE,1995,1906275,527713,2433988
United Arab Emirates,ARE,1996,2019417,553318,2572735
United Arab Emirates,ARE,1997,2167731,578388,2746119
United Arab Emirates,ARE,1998,2318735,602395,2921130
United Arab Emirates,ARE,1999,2472165,625398,3097563
United Arab Emirates,ARE,2000,2627996,647337,3275333
United Arab Emirates,ARE,2001,2785983,668215,3454198
United Arab Emirates,ARE,2002,2945695,687960,3633655
United Arab Emirates,ARE,2003,3106888,706555,3813443
United Arab Emirates,ARE,2004,3269387,723952,3993339
United Arab Emirates,ARE,2005,3521630,759363,4280993
United Arab Emirates,ARE,2006,4048888,850066,4898954
United Arab Emirates,ARE,2007,4875629,996995,5872624
United Arab Emirates,ARE,2008,5827655,1161030,6988685
United Arab Emirates,ARE,2009,6693200,1299444,7992644
United Arab Emirates,ARE,2010,7132067,1349704,8481771
United Arab Emirates,ARE,2011,7239445,1335760,8575205
United Arab Emirates,ARE,2012,7343475,1321494,8664969
United Arab Emirates,ARE,2013,7444846,1307001,8751847
United Arab Emirates,ARE,2014,7543693,1292258,8835951
United Arab Emirates,ARE,2015,7639464,1277435,8916899
United Arab Emirates,ARE,2016,7731918,1262345,8994263
United Arab Emirates,ARE,2017,7821224,1247072,9068296
United Arab Emirates,ARE,2018,7908257,1231912,9140169
United Arab Emirates,ARE,2019,7994705,1216952,9211657
United Arab Emirates,ARE,2020,8084399,1202890,9287289
United Arab Emirates,ARE,2021,8175678,1189467,9365145
United Kingdom,GBR,1960,41104656,11295344,52400000
United Kingdom,GBR,1961,41381472,11418528,52800000
United Kingdom,GBR,1962,41661202,11588798,53250000
United Kingdom,GBR,1963,41900114,11749886,53650000
United Kingdom,GBR,1964,42098400,11901600,54000000
United Kingdom,GBR,1965,42294196,12053854,54348050
United Kingdom,GBR,1966,42452048,12196452,54648500
United Kingdom,GBR,1967,42603817,12339783,54943600
United Kingdom,GBR,1968,42733856,12477844,55211700
United Kingdom,GBR,1969,42833742,12608008,55441750
United Kingdom,GBR,1970,42925829,12737421,55663250
United Kingdom,GBR,1971,43056861,12839362,55896223
United Kingdom,GBR,1972,43295638,12790427,56086065
United Kingdom,GBR,1973,43470962,12723565,56194527
United Kingdom,GBR,1974,43590038,12639936,56229974
United Kingdom,GBR,1975,43677888,12547912,56225800
United Kingdom,GBR,1976,43757644,12454324,56211968
United Kingdom,GBR,1977,43833733,12359759,56193492
United Kingdom,GBR,1978,43925435,12271069,56196504
United Kingdom,GBR,1979,44054299,12192652,56246951
United Kingdom,GBR,1980,44195960,12118256,56314216
United Kingdom,GBR,1981,44271630,12062199,56333829
United Kingdom,GBR,1982,44228171,12085470,56313641
United Kingdom,GBR,1983,44215089,12117759,56332848
United Kingdom,GBR,1984,44257473,12164599,56422072
United Kingdom,GBR,1985,44329755,12220513,56550268
United Kingdom,GBR,1986,44404206,12277190,56681396
United Kingdom,GBR,1987,44470325,12331725,56802050
United Kingdom,GBR,1988,44540723,12387604,56928327
United Kingdom,GBR,1989,44628280,12448431,57076711
United Kingdom,GBR,1990,44733264,12514322,57247586
United Kingdom,GBR,1991,44855736,12569161,57424897
United Kingdom,GBR,1992,45011752,12568650,57580402
United Kingdom,GBR,1993,45154426,12564188,57718614
United Kingdom,GBR,1994,45304828,12560917,57865745
United Kingdom,GBR,1995,45459651,12559379,58019030
United Kingdom,GBR,1996,45610451,12556499,58166950
United Kingdom,GBR,1997,45762480,12554474,58316954
United Kingdom,GBR,1998,45931122,12556019,58487141
United Kingdom,GBR,1999,46119137,12563329,58682466
United Kingdom,GBR,2000,46319551,12572963,58892514
United Kingdom,GBR,2001,46557334,12562339,59119673
United Kingdom,GBR,2002,46930583,12439896,59370479
United Kingdom,GBR,2003,47323791,12323786,59647577
United Kingdom,GBR,2004,47767769,12220136,59987905
United Kingdom,GBR,2005,48269624,12131582,60401206
United Kingdom,GBR,2006,48798541,12048279,60846820
United Kingdom,GBR,2007,49351705,11970758,61322463
United Kingdom,GBR,2008,49913475,11893520,61806995
United Kingdom,GBR,2009,50463084,11813186,62276270
United Kingdom,GBR,2010,51030310,11736055,62766365
United Kingdom,GBR,2011,51600211,11658599,63258810
United Kingdom,GBR,2012,52130345,11569870,63700215
United Kingdom,GBR,2013,52650595,11477678,64128273
United Kingdom,GBR,2014,53209683,11392615,64602298
United Kingdom,GBR,2015,53802927,11313292,65116219
United Kingdom,GBR,2016,54382825,11228768,65611593
United Kingdom,GBR,2017,54923317,11135542,66058859
United Kingdom,GBR,2018,55426598,11033746,66460344
United Kingdom,GBR,2019,55909924,10926403,66836327
United Kingdom,GBR,2020,56282971,10798029,67081000
United Kingdom,GBR,2021,56656654,10669915,67326569
United States,USA,1960,126462473,54208530,180671003
United States,USA,1961,129276215,54414784,183690999
United States,USA,1962,131988693,54549308,186538001
United States,USA,1963,134615404,54626596,189242000
United States,USA,1964,137215986,54673016,191889002
United States,USA,1965,139663053,54639948,194303001
United States,USA,1966,142008703,54551296,196559999
United States,USA,1967,144288757,54423244,198712001
United States,USA,1968,146463196,54242804,200706000
United States,USA,1969,148629124,54047876,202677000
United States,USA,1970,150922373,54129628,205052001
United States,USA,1971,152865492,54795508,207661000
United States,USA,1972,154531732,55364268,209896000
United States,USA,1973,156034954,55874050,211909004
United States,USA,1974,157488501,56365500,213854001
United States,USA,1975,159070594,56902410,215973004
United States,USA,1976,160611122,57423880,218035002
United States,USA,1977,162256678,57982320,220238998
United States,USA,1978,164005080,58579920,222585000
United States,USA,1979,165847531,59207468,225054999
United States,USA,1980,167551171,59673828,227224999
United States,USA,1981,169552427,59913572,229465999
United States,USA,1982,171528659,60135340,231663999
United States,USA,1983,173459636,60332364,233792000
United States,USA,1984,175321738,60503264,235825002
United States,USA,1985,177239105,60684896,237924001
United States,USA,1986,179244877,60888124,240133001
United States,USA,1987,181215212,61073788,242289000
United States,USA,1988,183232441,61266560,244499001
United States,USA,1989,185333919,61485080,246818999
United States,USA,1990,187966119,61656880,249622999
United States,USA,1991,191509147,61471852,252980999
United States,USA,1992,195199459,61314540,256513999
United States,USA,1993,198806845,61112156,259919001
United States,USA,1994,202278113,60847890,263126003
United States,USA,1995,205718394,60559610,266278004
United States,USA,1996,209146726,60247270,269393996
United States,USA,1997,212694273,59962730,272657003
United States,USA,1998,216206090,59647910,275854000
United States,USA,1999,219721677,59318324,279040001
United States,USA,2000,223069137,59093270,282162407
United States,USA,2001,225792302,59176652,284968954
United States,USA,2002,228400290,59224904,287625194
United States,USA,2003,230876596,59231336,290107932
United States,USA,2004,233532722,59272576,292805298
United States,USA,2005,236200507,59316092,295516599
United States,USA,2006,238999326,59380584,298379910
United States,USA,2007,241795278,59435930,301231208
United States,USA,2008,244607104,59486864,304093968
United States,USA,2009,247276259,59495270,306771529
United States,USA,2010,249849720,59477424,309327144
United States,USA,2011,252208133,59375348,311583481
United States,USA,2012,254614421,59263240,313877661
United States,USA,2013,256953576,59106372,316059948
United States,USA,2014,259430732,58955596,318386328
United States,USA,2015,261950744,58788250,320738994
United States,USA,2016,264473000,58598756,323071756
United States,USA,2017,266788716,58333412,325122128
United States,USA,2018,268844029,57994170,326838199
United States,USA,2019,270737596,57592356,328329952
United States,USA,2020,274032053,57469028,331501081
United States,USA,2021,275050303,56843440,331893743
United States Virgin Islands,VIR,1960,18355,14145,32500
United States Virgin Islands,VIR,1961,19847,14453,34300
United States Virgin Islands,VIR,1962,20734,14266,35000
United States Virgin Islands,VIR,1963,24120,15680,39800
United States Virgin Islands,VIR,1964,25276,15524,40800
United States Virgin Islands,VIR,1965,27526,15974,43500
United States Virgin Islands,VIR,1966,29839,16361,46200
United States Virgin Islands,VIR,1967,32344,16756,49100
United States Virgin Islands,VIR,1968,37397,18303,55700
United States Virgin Islands,VIR,1969,41232,19068,60300
United States Virgin Islands,VIR,1970,44174,19302,63476
United States Virgin Islands,VIR,1971,50208,20729,70937
United States Virgin Islands,VIR,1972,54905,21414,76319
United States Virgin Islands,VIR,1973,61467,22654,84121
United States Virgin Islands,VIR,1974,66711,23230,89941
United States Virgin Islands,VIR,1975,71094,23390,94484
United States Virgin Islands,VIR,1976,73363,22803,96166
United States Virgin Islands,VIR,1977,72044,21159,93203
United States Virgin Islands,VIR,1978,75091,20838,95929
United States Virgin Islands,VIR,1979,76204,19979,96183
United States Virgin Islands,VIR,1980,79855,19781,99636
United States Virgin Islands,VIR,1981,80915,18938,99853
United States Virgin Islands,VIR,1982,81947,18121,100068
United States Virgin Islands,VIR,1983,83005,17343,100348
United States Virgin Islands,VIR,1984,84015,16585,100600
United States Virgin Islands,VIR,1985,84921,15839,100760
United States Virgin Islands,VIR,1986,85733,15109,100842
United States Virgin Islands,VIR,1987,86498,14403,100901
United States Virgin Islands,VIR,1988,87230,13722,100952
United States Virgin Islands,VIR,1989,87965,13076,101041
United States Virgin Islands,VIR,1990,91160,12803,103963
United States Virgin Islands,VIR,1991,92529,12278,104807
United States Virgin Islands,VIR,1992,93936,11776,105712
United States Virgin Islands,VIR,1993,95290,11288,106578
United States Virgin Islands,VIR,1994,96515,10803,107318
United States Virgin Islands,VIR,1995,97507,10311,107818
United States Virgin Islands,VIR,1996,98277,9818,108095
United States Virgin Islands,VIR,1997,99010,9347,108357
United States Virgin Islands,VIR,1998,99649,8888,108537
United States Virgin Islands,VIR,1999,100159,8440,108599
United States Virgin Islands,VIR,2000,100587,8055,108642
United States Virgin Islands,VIR,2001,100749,7800,108549
United States Virgin Islands,VIR,2002,100952,7557,108509
United States Virgin Islands,VIR,2003,101182,7323,108505
United States Virgin Islands,VIR,2004,101373,7093,108466
United States Virgin Islands,VIR,2005,101581,6872,108453
United States Virgin Islands,VIR,2006,101716,6653,108369
United States Virgin Islands,VIR,2007,101894,6443,108337
United States Virgin Islands,VIR,2008,102152,6245,108397
United States Virgin Islands,VIR,2009,102354,6050,108404
United States Virgin Islands,VIR,2010,102499,5858,108357
United States Virgin Islands,VIR,2011,102617,5673,108290
United States Virgin Islands,VIR,2012,102691,5497,108188
United States Virgin Islands,VIR,2013,102715,5326,108041
United States Virgin Islands,VIR,2014,102718,5164,107882
United States Virgin Islands,VIR,2015,102703,5009,107712
United States Virgin Islands,VIR,2016,102656,4860,107516
United States Virgin Islands,VIR,2017,102564,4717,107281
United States Virgin Islands,VIR,2018,102422,4579,107001
United States Virgin Islands,VIR,2019,102223,4446,106669
United States Virgin Islands,VIR,2020,101974,4316,106290
United States Virgin Islands,VIR,2021,101678,4192,105870
Upper-middle-income countries,,1960,309227157,801687000,1110914157
Upper-middle-income countries,,1961,319439019,794914700,1114353719
Upper-middle-income countries,,1962,332085133,798212700,1130297833
Upper-middle-income countries,,1963,347130869,810495740,1157626609
Upper-middle-income countries,,1964,362594922,822013700,1184608622
Upper-middle-income countries,,1965,373101966,839398660,1212500626
Upper-middle-income countries,,1966,384270040,858947900,1243217940
Upper-middle-income countries,,1967,395682437,877295170,1272977607
Upper-middle-income countries,,1968,407391127,896238000,1303629127
Upper-middle-income countries,,1969,419487124,916391550,1335878674
Upper-middle-income countries,,1970,431834859,937074800,1368909659
Upper-middle-income countries,,1971,444618958,957870300,1402489258
Upper-middle-income countries,,1972,457185478,977133400,1434318878
Upper-middle-income countries,,1973,470668170,994654850,1465323020
Upper-middle-income countries,,1974,485046936,1009912640,1494959576
Upper-middle-income countries,,1975,499177747,1023079940,1522257687
Upper-middle-income countries,,1976,512824727,1035227260,1548051987
Upper-middle-income countries,,1977,526477074,1046146000,1572623074
Upper-middle-income countries,,1978,543455019,1053930240,1597385259
Upper-middle-income countries,,1979,563800338,1058558600,1622358938
Upper-middle-income countries,,1980,584367270,1062455230,1646822500
Upper-middle-income countries,,1981,605599814,1065997900,1671597714
Upper-middle-income countries,,1982,627915036,1070581100,1698496136
Upper-middle-income countries,,1983,649262517,1076352600,1725615117
Upper-middle-income countries,,1984,671087009,1080856300,1751943309
Upper-middle-income countries,,1985,693422053,1085494400,1778916453
Upper-middle-income countries,,1986,716500410,1091013200,1807513610
Upper-middle-income countries,,1987,740443248,1097329300,1837772548
Upper-middle-income countries,,1988,764826670,1103439400,1868266070
Upper-middle-income countries,,1989,788781253,1108815200,1897596453
Upper-middle-income countries,,1990,812198806,1113617900,1925816706
Upper-middle-income countries,,1991,836760110,1116238000,1952998110
Upper-middle-income countries,,1992,861003509,1117144600,1978148109
Upper-middle-income countries,,1993,885480666,1116969900,2002450566
Upper-middle-income countries,,1994,910469299,1116158000,2026627299
Upper-middle-income countries,,1995,935500351,1114390800,2049891151
Upper-middle-income countries,,1996,960793865,1112025300,2072819165
Upper-middle-income countries,,1997,986405432,1108941000,2095346432
Upper-middle-income countries,,1998,1012252402,1104767900,2117020302
Upper-middle-income countries,,1999,1038038326,1099304800,2137343126
Upper-middle-income countries,,2000,1063986983,1092514200,2156501183
Upper-middle-income countries,,2001,1092331859,1082377500,2174709359
Upper-middle-income countries,,2002,1122092954,1070002300,2192095254
Upper-middle-income countries,,2003,1152196669,1056657150,2208853819
Upper-middle-income countries,,2004,1182729885,1042604900,2225334785
Upper-middle-income countries,,2005,1213751340,1028079170,2241830510
Upper-middle-income countries,,2006,1244220885,1013319500,2257540385
Upper-middle-income countries,,2007,1274334502,998143200,2272477702
Upper-middle-income countries,,2008,1305264310,982922900,2288187210
Upper-middle-income countries,,2009,1336774453,967598100,2304372553
Upper-middle-income countries,,2010,1368245706,951772160,2320017866
Upper-middle-income countries,,2011,1399498063,937364900,2336862963
Upper-middle-income countries,,2012,1431823667,924312000,2356135667
Upper-middle-income countries,,2013,1465171083,911274560,2376445643
Upper-middle-income countries,,2014,1498951663,897799200,2396750863
Upper-middle-income countries,,2015,1532338785,883832700,2416171485
Upper-middle-income countries,,2016,1564963701,869302660,2434266361
Upper-middle-income countries,,2017,1597344399,854664060,2452008459
Upper-middle-income countries,,2018,1628494865,839509200,2468004065
Upper-middle-income countries,,2019,1658181075,823954100,2482135175
Upper-middle-income countries,,2020,1685638790,807856500,2493495290
Upper-middle-income countries,,2021,1710307508,791042800,2501350308
Uruguay,URY,1960,2029312,499709,2529021
Uruguay,URY,1961,2060755,500398,2561153
Uruguay,URY,1962,2091607,500834,2592441
Uruguay,URY,1963,2121929,501007,2622936
Uruguay,URY,1964,2151448,500928,2652376
Uruguay,URY,1965,2179938,500489,2680427
Uruguay,URY,1966,2207285,499745,2707030
Uruguay,URY,1967,2233258,498589,2731847
Uruguay,URY,1968,2257465,496952,2754417
Uruguay,URY,1969,2279194,494763,2773957
Uruguay,URY,1970,2298285,491980,2790265
Uruguay,URY,1971,2316495,488997,2805492
Uruguay,URY,1972,2335041,486045,2821086
Uruguay,URY,1973,2353714,483111,2836825
Uruguay,URY,1974,2373244,480344,2853588
Uruguay,URY,1975,2394830,477117,2871947
Uruguay,URY,1976,2422910,468184,2891094
Uruguay,URY,1977,2450090,459237,2909327
Uruguay,URY,1978,2475729,450111,2925840
Uruguay,URY,1979,2499884,440845,2940729
Uruguay,URY,1980,2522325,431425,2953750
Uruguay,URY,1981,2543974,422102,2966076
Uruguay,URY,1982,2566208,412974,2979182
Uruguay,URY,1983,2589132,404153,2993285
Uruguay,URY,1984,2612669,395586,3008255
Uruguay,URY,1985,2636937,387281,3024218
Uruguay,URY,1986,2662818,378387,3041205
Uruguay,URY,1987,2689469,369318,3058787
Uruguay,URY,1988,2717200,360560,3077760
Uruguay,URY,1989,2745752,352137,3097889
Uruguay,URY,1990,2773299,343713,3117012
Uruguay,URY,1991,2800014,335360,3135374
Uruguay,URY,1992,2826595,327137,3153732
Uruguay,URY,1993,2852669,319078,3171747
Uruguay,URY,1994,2878766,311179,3189945
Uruguay,URY,1995,2904859,303441,3208300
Uruguay,URY,1996,2930912,295721,3226633
Uruguay,URY,1997,2957783,287286,3245069
Uruguay,URY,1998,2983724,278959,3262683
Uruguay,URY,1999,3008219,270744,3278963
Uruguay,URY,2000,3029768,262456,3292224
Uruguay,URY,2001,3046866,254073,3300939
Uruguay,URY,2002,3060739,245702,3306441
Uruguay,URY,2003,3072794,237408,3310202
Uruguay,URY,2004,3084420,229381,3313801
Uruguay,URY,2005,3096012,221653,3317665
Uruguay,URY,2006,3108094,214188,3322282
Uruguay,URY,2007,3121576,207075,3328651
Uruguay,URY,2008,3135892,200234,3336126
Uruguay,URY,2009,3150496,193660,3344156
Uruguay,URY,2010,3165372,187279,3352651
Uruguay,URY,2011,3180512,181125,3361637
Uruguay,URY,2012,3193778,177355,3371133
Uruguay,URY,2013,3206813,174367,3381180
Uruguay,URY,2014,3220213,171449,3391662
Uruguay,URY,2015,3234208,168610,3402818
Uruguay,URY,2016,3247994,165772,3413766
Uruguay,URY,2017,3259303,162897,3422200
Uruguay,URY,2018,3267136,159906,3427042
Uruguay,URY,2019,3271594,156815,3428409
Uruguay,URY,2020,3275291,153795,3429086
Uruguay,URY,2021,3275607,150653,3426260
Uzbekistan,UZB,1960,2844744,5527567,8372311
Uzbekistan,UZB,1961,2975983,5716065,8692048
Uzbekistan,UZB,1962,3118187,5920035,9038222
Uzbekistan,UZB,1963,3265747,6128841,9394588
Uzbekistan,UZB,1964,3417791,6340356,9758147
Uzbekistan,UZB,1965,3574810,6555286,10130096
Uzbekistan,UZB,1966,3734937,6770032,10504969
Uzbekistan,UZB,1967,3897765,6983768,10881533
Uzbekistan,UZB,1968,4063974,7197626,11261600
Uzbekistan,UZB,1969,4232202,7409438,11641640
Uzbekistan,UZB,1970,4409851,7601510,12011361
Uzbekistan,UZB,1971,4599705,7770415,12370120
Uzbekistan,UZB,1972,4794957,7938285,12733242
Uzbekistan,UZB,1973,4998184,8109744,13107928
Uzbekistan,UZB,1974,5210038,8284673,13494711
Uzbekistan,UZB,1975,5430883,8463464,13894347
Uzbekistan,UZB,1976,5661151,8646246,14307397
Uzbekistan,UZB,1977,5900197,8831512,14731709
Uzbekistan,UZB,1978,6142953,9011361,15154314
Uzbekistan,UZB,1979,6347101,9211806,15558907
Uzbekistan,UZB,1980,6503558,9443571,15947129
Uzbekistan,UZB,1981,6660041,9675601,16335642
Uzbekistan,UZB,1982,6821113,9914530,16735643
Uzbekistan,UZB,1983,6989103,10163754,17152857
Uzbekistan,UZB,1984,7166888,10427476,17594364
Uzbekistan,UZB,1985,7355697,10707504,18063201
Uzbekistan,UZB,1986,7555779,11004229,18560008
Uzbekistan,UZB,1987,7763836,11313334,19077170
Uzbekistan,UZB,1988,7974271,11625757,19600028
Uzbekistan,UZB,1989,8221484,11881418,20102902
Uzbekistan,UZB,1990,8483962,12026038,20510000
Uzbekistan,UZB,1991,8765479,12186521,20952000
Uzbekistan,UZB,1992,9074643,12374357,21449000
Uzbekistan,UZB,1993,9386788,12555212,21942000
Uzbekistan,UZB,1994,9679171,12697829,22377000
Uzbekistan,UZB,1995,9964108,12820892,22785000
Uzbekistan,UZB,1996,10267308,12957692,23225000
Uzbekistan,UZB,1997,10575599,13091401,23667000
Uzbekistan,UZB,1998,10862394,13188606,24051000
Uzbekistan,UZB,1999,11096810,13214840,24311650
Uzbekistan,UZB,2000,11370244,13280156,24650400
Uzbekistan,UZB,2001,11634932,13329518,24964450
Uzbekistan,UZB,2002,11900009,13371841,25271850
Uzbekistan,UZB,2003,12162787,13404863,25567650
Uzbekistan,UZB,2004,12428855,13435495,25864350
Uzbekistan,UZB,2005,12700677,13466323,26167000
Uzbekistan,UZB,2006,12984805,13503445,26488250
Uzbekistan,UZB,2007,13301003,13566997,26868000
Uzbekistan,UZB,2008,13648397,13654403,27302800
Uzbekistan,UZB,2009,14014762,13752638,27767400
Uzbekistan,UZB,2010,14554257,14008143,28562400
Uzbekistan,UZB,2011,15007103,14332297,29339400
Uzbekistan,UZB,2012,15199882,14574618,29774500
Uzbekistan,UZB,2013,15408910,14834290,30243200
Uzbekistan,UZB,2014,15640290,15117410,30757700
Uzbekistan,UZB,2015,15884192,15414708,31298900
Uzbekistan,UZB,2016,16130961,15716939,31847900
Uzbekistan,UZB,2017,16372437,16016163,32388600
Uzbekistan,UZB,2018,16635580,16320520,32956100
Uzbekistan,UZB,2019,16935578,16644772,33580350
Uzbekistan,UZB,2020,17258430,16973620,34232050
Uzbekistan,UZB,2021,17606637,17308464,34915101
Vanuatu,VUT,1960,6722,57886,64608
Vanuatu,VUT,1961,7034,59428,66462
Vanuatu,VUT,1962,7362,61029,68391
Vanuatu,VUT,1963,7709,62691,70400
Vanuatu,VUT,1964,8074,64419,72493
Vanuatu,VUT,1965,8460,66217,74677
Vanuatu,VUT,1966,8866,68079,76945
Vanuatu,VUT,1967,9294,70017,79311
Vanuatu,VUT,1968,9747,72035,81782
Vanuatu,VUT,1969,10223,74127,84350
Vanuatu,VUT,1970,10725,76294,87019
Vanuatu,VUT,1971,11254,78542,89796
Vanuatu,VUT,1972,11812,80875,92687
Vanuatu,VUT,1973,12399,83288,95687
Vanuatu,VUT,1974,13016,85774,98790
Vanuatu,VUT,1975,13664,88346,102010
Vanuatu,VUT,1976,14346,90995,105341
Vanuatu,VUT,1977,15059,93710,108769
Vanuatu,VUT,1978,15789,96396,112185
Vanuatu,VUT,1979,16573,98771,115344
Vanuatu,VUT,1980,17416,100740,118156
Vanuatu,VUT,1981,18278,102609,120887
Vanuatu,VUT,1982,19191,104557,123748
Vanuatu,VUT,1983,20158,106585,126743
Vanuatu,VUT,1984,21182,108691,129873
Vanuatu,VUT,1985,22260,110859,133119
Vanuatu,VUT,1986,23398,113090,136488
Vanuatu,VUT,1987,24594,115362,139956
Vanuatu,VUT,1988,25851,117677,143528
Vanuatu,VUT,1989,27133,120048,147181
Vanuatu,VUT,1990,28238,122644,150882
Vanuatu,VUT,1991,29386,125292,154678
Vanuatu,VUT,1992,30582,127995,158577
Vanuatu,VUT,1993,31817,130731,162548
Vanuatu,VUT,1994,33092,133468,166560
Vanuatu,VUT,1995,34402,136210,170612
Vanuatu,VUT,1996,35753,138961,174714
Vanuatu,VUT,1997,37144,141727,178871
Vanuatu,VUT,1998,38582,144506,183088
Vanuatu,VUT,1999,40077,147355,187432
Vanuatu,VUT,2000,41628,150446,192074
Vanuatu,VUT,2001,43255,153779,197034
Vanuatu,VUT,2002,44942,157183,202125
Vanuatu,VUT,2003,46677,160581,207258
Vanuatu,VUT,2004,48451,163971,212422
Vanuatu,VUT,2005,50271,167361,217632
Vanuatu,VUT,2006,52146,170777,222923
Vanuatu,VUT,2007,54088,174257,228345
Vanuatu,VUT,2008,56113,177839,233952
Vanuatu,VUT,2009,58211,181478,239689
Vanuatu,VUT,2010,60043,185410,245453
Vanuatu,VUT,2011,61720,189574,251294
Vanuatu,VUT,2012,63456,193857,257313
Vanuatu,VUT,2013,65254,198280,263534
Vanuatu,VUT,2014,67107,202820,269927
Vanuatu,VUT,2015,69002,207436,276438
Vanuatu,VUT,2016,70980,212238,283218
Vanuatu,VUT,2017,73033,217206,290239
Vanuatu,VUT,2018,75139,222159,297298
Vanuatu,VUT,2019,77300,227104,304404
Vanuatu,VUT,2020,79558,232127,311685
Vanuatu,VUT,2021,81907,237230,319137
Venezuela,VEN,1960,5025734,3131203,8156937
Venezuela,VEN,1961,5314890,3138216,8453106
Venezuela,VEN,1962,5596747,3157335,8754082
Venezuela,VEN,1963,5886886,3173067,9059953
Venezuela,VEN,1964,6185923,3185410,9371333
Venezuela,VEN,1965,6493184,3194954,9688138
Venezuela,VEN,1966,6809468,3201217,10010685
Venezuela,VEN,1967,7134322,3204526,10338848
Venezuela,VEN,1968,7467976,3204678,10672654
Venezuela,VEN,1969,7809239,3202096,11011335
Venezuela,VEN,1970,8159136,3196339,11355475
Venezuela,VEN,1971,8517517,3188157,11705674
Venezuela,VEN,1972,8874338,3187283,12061621
Venezuela,VEN,1973,9234736,3190068,12424804
Venezuela,VEN,1974,9605227,3190993,12796220
Venezuela,VEN,1975,9985857,3190530,13176387
Venezuela,VEN,1976,10377533,3188579,13566112
Venezuela,VEN,1977,10779637,3185613,13965250
Venezuela,VEN,1978,11191936,3181023,14372959
Venezuela,VEN,1979,11613871,3174652,14788523
Venezuela,VEN,1980,12044389,3166054,15210443
Venezuela,VEN,1981,12482592,3155834,15638426
Venezuela,VEN,1982,12918717,3152937,16071654
Venezuela,VEN,1983,13357419,3152177,16509596
Venezuela,VEN,1984,13803662,3149572,16953234
Venezuela,VEN,1985,14256838,3145466,17402304
Venezuela,VEN,1986,14720573,3140299,17860872
Venezuela,VEN,1987,15194455,3134200,18328655
Venezuela,VEN,1988,15674578,3126192,18800770
Venezuela,VEN,1989,16159056,3116236,19275292
Venezuela,VEN,1990,16646578,3104001,19750579
Venezuela,VEN,1991,17124322,3101892,20226214
Venezuela,VEN,1992,17597876,3102585,20700461
Venezuela,VEN,1993,18070811,3101289,21172100
Venezuela,VEN,1994,18543164,3097669,21640833
Venezuela,VEN,1995,19015361,3091925,22107286
Venezuela,VEN,1996,19487857,3084253,22572110
Venezuela,VEN,1997,19962047,3075514,23037561
Venezuela,VEN,1998,20438686,3065133,23503819
Venezuela,VEN,1999,20914049,3052911,23966960
Venezuela,VEN,2000,21388675,3039054,24427729
Venezuela,VEN,2001,21857258,3022945,24880203
Venezuela,VEN,2002,22259807,3071122,25330929
Venezuela,VEN,2003,22662919,3119110,25782029
Venezuela,VEN,2004,23060812,3166115,26226927
Venezuela,VEN,2005,23456263,3212522,26668785
Venezuela,VEN,2006,23844411,3257670,27102081
Venezuela,VEN,2007,24223737,3301360,27525097
Venezuela,VEN,2008,24590433,3343400,27933833
Venezuela,VEN,2009,24944692,3383200,28327892
Venezuela,VEN,2010,25293053,3421969,28715022
Venezuela,VEN,2011,25636044,3460115,29096159
Venezuela,VEN,2012,25970224,3500202,29470426
Venezuela,VEN,2013,26297143,3540878,29838021
Venezuela,VEN,2014,26613545,3579713,30193258
Venezuela,VEN,2015,26913166,3616550,30529716
Venezuela,VEN,2016,27103212,3638252,30741464
Venezuela,VEN,2017,26951752,3611681,30563433
Venezuela,VEN,2018,26308612,3517041,29825653
Venezuela,VEN,2019,25564613,3407070,28971683
Venezuela,VEN,2020,25151087,3339366,28490453
Venezuela,VEN,2021,24907533,3292334,28199867
Vietnam,VNM,1960,4809614,27908848,32718462
Vietnam,VNM,1961,5053720,28568262,33621982
Vietnam,VNM,1962,5307513,29226376,34533889
Vietnam,VNM,1963,5582670,29944056,35526726
Vietnam,VNM,1964,5864832,30644334,36509166
Vietnam,VNM,1965,6152305,31313772,37466077
Vietnam,VNM,1966,6443077,31945132,38388209
Vietnam,VNM,1967,6738138,32544426,39282564
Vietnam,VNM,1968,7037067,33108220,40145287
Vietnam,VNM,1969,7346352,33669510,41015862
Vietnam,VNM,1970,7672979,34255870,41928849
Vietnam,VNM,1971,7894942,35021680,42916622
Vietnam,VNM,1972,8119101,35786920,43906021
Vietnam,VNM,1973,8344391,36546890,44891281
Vietnam,VNM,1974,8576172,37322530,45898702
Vietnam,VNM,1975,8821833,38147784,46969617
Vietnam,VNM,1976,9093283,39070290,48163573
Vietnam,VNM,1977,9378577,40039572,49418149
Vietnam,VNM,1978,9671810,41029650,50701460
Vietnam,VNM,1979,9938669,41892720,51831389
Vietnam,VNM,1980,10194803,42773468,52968271
Vietnam,VNM,1981,10481001,43799390,54280391
Vietnam,VNM,1982,10777061,44855092,55632153
Vietnam,VNM,1983,11080174,45931270,57011444
Vietnam,VNM,1984,11388170,47018692,58406862
Vietnam,VNM,1985,11699691,48111624,59811315
Vietnam,VNM,1986,12014642,49206464,61221106
Vietnam,VNM,1987,12330749,50300040,62630789
Vietnam,VNM,1988,12648690,51388824,64037514
Vietnam,VNM,1989,13021914,52444450,65466364
Vietnam,VNM,1990,13554488,53358124,66912612
Vietnam,VNM,1991,14101741,54257080,68358821
Vietnam,VNM,1992,14659824,55128924,69788748
Vietnam,VNM,1993,15222498,55953908,71176406
Vietnam,VNM,1994,15786387,56714700,72501087
Vietnam,VNM,1995,16349444,57409664,73759108
Vietnam,VNM,1996,16910167,58036280,74946447
Vietnam,VNM,1997,17466858,58591744,76058602
Vietnam,VNM,1998,18025684,59102740,77128424
Vietnam,VNM,1999,18606725,59516988,78123713
Vietnam,VNM,2000,19255738,59745404,79001142
Vietnam,VNM,2001,19904159,59913616,79817775
Vietnam,VNM,2002,20572659,60069650,80642309
Vietnam,VNM,2003,21258672,60217150,81475822
Vietnam,VNM,2004,21963105,60348120,82311225
Vietnam,VNM,2005,22681995,60460100,83142095
Vietnam,VNM,2006,23412478,60539320,83951798
Vietnam,VNM,2007,24160637,60601630,84762267
Vietnam,VNM,2008,24932764,60664476,85597240
Vietnam,VNM,2009,25739048,60743876,86482924
Vietnam,VNM,2010,26587808,60823204,87411012
Vietnam,VNM,2011,27458906,60890212,88349118
Vietnam,VNM,2012,28354957,60946370,89301327
Vietnam,VNM,2013,29272925,60994816,90267741
Vietnam,VNM,2014,30212637,61022868,91235505
Vietnam,VNM,2015,31168990,61022410,92191400
Vietnam,VNM,2016,32137965,60988564,93126529
Vietnam,VNM,2017,33111857,60921190,94033047
Vietnam,VNM,2018,34092278,60822052,94914330
Vietnam,VNM,2019,35081096,60695620,95776716
Vietnam,VNM,2020,36088619,60560064,96648683
Vietnam,VNM,2021,37088534,60379496,97468030
World,OWID_WRL,1960,1018346900,2012266800,3030613700
World,OWID_WRL,1961,1047059196,2024481200,3071540396
World,OWID_WRL,1962,1079093102,2046843300,3125936402
World,OWID_WRL,1963,1114097698,2078384600,3192482298
World,OWID_WRL,1964,1149993775,2109469300,3259463075
World,OWID_WRL,1965,1181126807,2146075000,3327201807
World,OWID_WRL,1966,1212826826,2184623400,3397450226
World,OWID_WRL,1967,1245143597,2222173200,3467316797
World,OWID_WRL,1968,1278269071,2260817200,3539086271
World,OWID_WRL,1969,1312244276,2301227800,3613472076
World,OWID_WRL,1970,1346710018,2342372000,3689082018
World,OWID_WRL,1971,1382655488,2384114700,3766770188
World,OWID_WRL,1972,1418608135,2423803100,3842411235
World,OWID_WRL,1973,1455947299,2462838000,3918785299
World,OWID_WRL,1974,1494685682,2499940900,3994626582
World,OWID_WRL,1975,1531838269,2536900600,4068738869
World,OWID_WRL,1976,1570131253,2571656400,4141787653
World,OWID_WRL,1977,1608913768,2605590000,4214503768
World,OWID_WRL,1978,1651535788,2636911600,4288447388
World,OWID_WRL,1979,1698389133,2665963000,4364352133
World,OWID_WRL,1980,1746597581,2694314200,4440911781
World,OWID_WRL,1981,1796691530,2722739700,4519431230
World,OWID_WRL,1982,1846604858,2754568000,4601172858
World,OWID_WRL,1983,1895627253,2787689500,4683316753
World,OWID_WRL,1984,1945643514,2819413000,4765056514
World,OWID_WRL,1985,1997054715,2851408400,4848463115
World,OWID_WRL,1986,2050400658,2883961600,4934362258
World,OWID_WRL,1987,2105499909,2917112300,5022612209
World,OWID_WRL,1988,2161590919,2950087000,5111677919
World,OWID_WRL,1989,2217844389,2983001000,5200845389
World,OWID_WRL,1990,2275576715,3016050200,5291626915
World,OWID_WRL,1991,2333701812,3047027500,5380729312
World,OWID_WRL,1992,2391631835,3076684000,5468315835
World,OWID_WRL,1993,2449347491,3105380900,5554728391
World,OWID_WRL,1994,2507390396,3132712000,5640102396
World,OWID_WRL,1995,2565653779,3159089700,5724743479
World,OWID_WRL,1996,2624424124,3185112600,5809536724
World,OWID_WRL,1997,2683939855,3210022700,5893962555
World,OWID_WRL,1998,2744145319,3233590000,5977735319
World,OWID_WRL,1999,2804643704,3255847000,6060490704
World,OWID_WRL,2000,2866001986,3276591000,6142592986
World,OWID_WRL,2001,2931982375,3292625700,6224608075
World,OWID_WRL,2002,3001375881,3304983300,6306359181
World,OWID_WRL,2003,3071458625,3316189400,6387648025
World,OWID_WRL,2004,3142901966,3326182000,6469083966
World,OWID_WRL,2005,3215717849,3335114500,6550832349
World,OWID_WRL,2006,3289337823,3343844000,6633181823
World,OWID_WRL,2007,3363570859,3352302600,6715873459
World,OWID_WRL,2008,3439970487,3359655000,6799625487
World,OWID_WRL,2009,3516826565,3366866700,6883693265
World,OWID_WRL,2010,3593889101,3373930800,6967819901
World,OWID_WRL,2011,3668565395,3383140600,7051705995
World,OWID_WRL,2012,3745429795,3393622800,7139052595
World,OWID_WRL,2013,3824116789,3403214000,7227330789
World,OWID_WRL,2014,3904237467,3411423200,7315660667
World,OWID_WRL,2015,3985184642,3417903000,7403087642
World,OWID_WRL,2016,4066384935,3423736800,7490121735
World,OWID_WRL,2017,4147418821,3428913400,7576332221
World,OWID_WRL,2018,4227439914,3432505600,7659945514
World,OWID_WRL,2019,4306260787,3434599200,7740859987
World,OWID_WRL,2020,4383714769,3435444000,7819158769
World,OWID_WRL,2021,4454152526,3432438300,7886590826
Yemen,YEM,1960,504364,5038095,5542459
Yemen,YEM,1961,534118,5112550,5646668
Yemen,YEM,1962,565615,5187771,5753386
Yemen,YEM,1963,598678,5261519,5860197
Yemen,YEM,1964,634059,5339744,5973803
Yemen,YEM,1965,672288,5425010,6097298
Yemen,YEM,1966,713218,5515212,6228430
Yemen,YEM,1967,757221,5610793,6368014
Yemen,YEM,1968,804519,5711385,6515904
Yemen,YEM,1969,855271,5818710,6673981
Yemen,YEM,1970,910200,5933407,6843607
Yemen,YEM,1971,955150,6069046,7024196
Yemen,YEM,1972,1003073,6212762,7215835
Yemen,YEM,1973,1053986,6363750,7417736
Yemen,YEM,1974,1108209,6521981,7630190
Yemen,YEM,1975,1166094,6689563,7855657
Yemen,YEM,1976,1228090,6866895,8094985
Yemen,YEM,1977,1294135,7054047,8348182
Yemen,YEM,1978,1364664,7250637,8615301
Yemen,YEM,1979,1440274,7459648,8899922
Yemen,YEM,1980,1521944,7682994,9204938
Yemen,YEM,1981,1609371,7919734,9529105
Yemen,YEM,1982,1703069,8169223,9872292
Yemen,YEM,1983,1803726,8433665,10237391
Yemen,YEM,1984,1911880,8713807,10625687
Yemen,YEM,1985,2027813,9009105,11036918
Yemen,YEM,1986,2156421,9309023,11465444
Yemen,YEM,1987,2302444,9613119,11915563
Yemen,YEM,1988,2458743,9928495,12387238
Yemen,YEM,1989,2624031,10248331,12872362
Yemen,YEM,1990,2799547,10575574,13375121
Yemen,YEM,1991,2986079,10909772,13895851
Yemen,YEM,1992,3183801,11249970,14433771
Yemen,YEM,1993,3392694,11595353,14988047
Yemen,YEM,1994,3612224,11940947,15553171
Yemen,YEM,1995,3826153,12277186,16103339
Yemen,YEM,1996,4028808,12585518,16614326
Yemen,YEM,1997,4233201,12875480,17108681
Yemen,YEM,1998,4444997,13163136,17608133
Yemen,YEM,1999,4664859,13449693,18114552
Yemen,YEM,2000,4893201,13735499,18628700
Yemen,YEM,2001,5127958,14015499,19143457
Yemen,YEM,2002,5370307,14290346,19660653
Yemen,YEM,2003,5622379,14566420,20188799
Yemen,YEM,2004,5886214,14847192,20733406
Yemen,YEM,2005,6169349,15151322,21320671
Yemen,YEM,2006,6477861,15488437,21966298
Yemen,YEM,2007,6804009,15837529,22641538
Yemen,YEM,2008,7143108,16185896,23329004
Yemen,YEM,2009,7495790,16533799,24029589
Yemen,YEM,2010,7862636,16881310,24743946
Yemen,YEM,2011,8244926,17230684,25475610
Yemen,YEM,2012,8642705,17580686,26223391
Yemen,YEM,2013,9055561,17928440,26984001
Yemen,YEM,2014,9481916,18271388,27753304
Yemen,YEM,2015,9917199,18599346,28516545
Yemen,YEM,2016,10361240,18912762,29274002
Yemen,YEM,2017,10817186,19217204,30034390
Yemen,YEM,2018,11282260,19508252,30790512
Yemen,YEM,2019,11758398,19788292,31546690
Yemen,YEM,2020,12238236,20045810,32284046
Yemen,YEM,2021,12713103,20268538,32981641
Zambia,ZMB,1960,566021,2553409,3119430
Zambia,ZMB,1961,610118,2609333,3219451
Zambia,ZMB,1962,657540,2665887,3323427
Zambia,ZMB,1963,710708,2720673,3431381
Zambia,ZMB,1964,779939,2762825,3542764
Zambia,ZMB,1965,854953,2803071,3658024
Zambia,ZMB,1966,936449,2841231,3777680
Zambia,ZMB,1967,1024517,2876771,3901288
Zambia,ZMB,1968,1119747,2909426,4029173
Zambia,ZMB,1969,1221500,2937507,4159007
Zambia,ZMB,1970,1299530,2982141,4281671
Zambia,ZMB,1971,1374579,3025340,4399919
Zambia,ZMB,1972,1454150,3069431,4523581
Zambia,ZMB,1973,1538424,3114865,4653289
Zambia,ZMB,1974,1627890,3161148,4789038
Zambia,ZMB,1975,1722683,3208566,4931249
Zambia,ZMB,1976,1823094,3256578,5079672
Zambia,ZMB,1977,1928730,3304562,5233292
Zambia,ZMB,1978,2039657,3351698,5391355
Zambia,ZMB,1979,2155743,3397719,5553462
Zambia,ZMB,1980,2277592,3442846,5720438
Zambia,ZMB,1981,2350382,3547099,5897481
Zambia,ZMB,1982,2424450,3666368,6090818
Zambia,ZMB,1983,2501015,3790055,6291070
Zambia,ZMB,1984,2576089,3911983,6488072
Zambia,ZMB,1985,2651511,4034938,6686449
Zambia,ZMB,1986,2729236,4161731,6890967
Zambia,ZMB,1987,2806571,4288614,7095185
Zambia,ZMB,1988,2881696,4412629,7294325
Zambia,ZMB,1989,2955757,4535518,7491275
Zambia,ZMB,1990,3028980,4657421,7686401
Zambia,ZMB,1991,3072515,4807951,7880466
Zambia,ZMB,1992,3109750,4964587,8074337
Zambia,ZMB,1993,3146422,5124495,8270917
Zambia,ZMB,1994,3183932,5290284,8474216
Zambia,ZMB,1995,3222161,5461974,8684135
Zambia,ZMB,1996,3261522,5640497,8902019
Zambia,ZMB,1997,3304011,5829145,9133156
Zambia,ZMB,1998,3347457,6024973,9372430
Zambia,ZMB,1999,3392256,6228982,9621238
Zambia,ZMB,2000,3442313,6448823,9891136
Zambia,ZMB,2001,3567391,6624573,10191964
Zambia,ZMB,2002,3727817,6780477,10508294
Zambia,ZMB,2003,3896360,6941613,10837973
Zambia,ZMB,2004,4075803,7112237,11188040
Zambia,ZMB,2005,4268709,7296161,11564870
Zambia,ZMB,2006,4476767,7494800,11971567
Zambia,ZMB,2007,4698029,7704044,12402073
Zambia,ZMB,2008,4931812,7921154,12852966
Zambia,ZMB,2009,5175542,8142545,13318087
Zambia,ZMB,2010,5427875,8364211,13792086
Zambia,ZMB,2011,5685070,8580744,14265814
Zambia,ZMB,2012,5950059,8794599,14744658
Zambia,ZMB,2013,6225773,9009203,15234976
Zambia,ZMB,2014,6512613,9225180,15737793
Zambia,ZMB,2015,6809146,9439084,16248230
Zambia,ZMB,2016,7115902,9651859,16767761
Zambia,ZMB,2017,7434012,9864042,17298054
Zambia,ZMB,2018,7762359,10073534,17835893
Zambia,ZMB,2019,8100644,10279833,18380477
Zambia,ZMB,2020,8447250,10480465,18927715
Zambia,ZMB,2021,8800295,10672830,19473125
Zimbabwe,ZWE,1960,479900,3326410,3806310
Zimbabwe,ZWE,1961,503346,3422606,3925952
Zimbabwe,ZWE,1962,529792,3519986,4049778
Zimbabwe,ZWE,1963,567279,3610652,4177931
Zimbabwe,ZWE,1964,607412,3702920,4310332
Zimbabwe,ZWE,1965,650173,3796976,4447149
Zimbabwe,ZWE,1966,695850,3892679,4588529
Zimbabwe,ZWE,1967,744625,3990069,4734694
Zimbabwe,ZWE,1968,796768,4089579,4886347
Zimbabwe,ZWE,1969,851455,4192708,5044163
Zimbabwe,ZWE,1970,903331,4299587,5202918
Zimbabwe,ZWE,1971,957639,4405784,5363423
Zimbabwe,ZWE,1972,1015830,4517012,5532842
Zimbabwe,ZWE,1973,1078217,4634495,5712712
Zimbabwe,ZWE,1974,1145285,4758245,5903530
Zimbabwe,ZWE,1975,1211673,4885410,6097083
Zimbabwe,ZWE,1976,1280064,5008323,6288387
Zimbabwe,ZWE,1977,1345202,5107842,6453044
Zimbabwe,ZWE,1978,1397959,5151390,6549349
Zimbabwe,ZWE,1979,1454499,5201334,6655833
Zimbabwe,ZWE,1980,1577139,5472787,7049926
Zimbabwe,ZWE,1981,1718619,5787907,7506526
Zimbabwe,ZWE,1982,1828365,5975490,7803855
Zimbabwe,ZWE,1983,1951119,6155237,8106356
Zimbabwe,ZWE,1984,2077470,6321097,8398567
Zimbabwe,ZWE,1985,2208607,6481908,8690515
Zimbabwe,ZWE,1986,2345024,6638020,8983044
Zimbabwe,ZWE,1987,2487202,6790286,9277488
Zimbabwe,ZWE,1988,2633700,6935039,9568739
Zimbabwe,ZWE,1989,2781593,7064753,9846346
Zimbabwe,ZWE,1990,2931815,7182078,10113893
Zimbabwe,ZWE,1991,3086155,7291660,10377815
Zimbabwe,ZWE,1992,3245551,7395950,10641501
Zimbabwe,ZWE,1993,3339948,7454970,10794918
Zimbabwe,ZWE,1994,3402540,7456054,10858594
Zimbabwe,ZWE,1995,3488629,7505412,10994041
Zimbabwe,ZWE,1996,3591770,7586401,11178171
Zimbabwe,ZWE,1997,3696644,7665757,11362401
Zimbabwe,ZWE,1998,3803916,7744448,11548364
Zimbabwe,ZWE,1999,3907086,7809368,11716454
Zimbabwe,ZWE,2000,3995150,7839526,11834676
Zimbabwe,ZWE,2001,4069981,7840997,11910978
Zimbabwe,ZWE,2002,4144889,7839755,11984644
Zimbabwe,ZWE,2003,4163625,7912203,12075828
Zimbabwe,ZWE,2004,4170453,7990428,12160881
Zimbabwe,ZWE,2005,4169863,8054890,12224753
Zimbabwe,ZWE,2006,4183242,8147248,12330490
Zimbabwe,ZWE,2007,4201195,8249373,12450568
Zimbabwe,ZWE,2008,4211896,8338451,12550347
Zimbabwe,ZWE,2009,4232267,8447543,12679810
Zimbabwe,ZWE,2010,4262290,8577481,12839771
Zimbabwe,ZWE,2011,4300463,8725322,13025785
Zimbabwe,ZWE,2012,4355539,8909792,13265331
Zimbabwe,ZWE,2013,4426387,9129035,13555422
Zimbabwe,ZWE,2014,4503674,9352079,13855753
Zimbabwe,ZWE,2015,4584076,9570861,14154937
Zimbabwe,ZWE,2016,4667645,9785059,14452704
Zimbabwe,ZWE,2017,4755312,9995789,14751101
Zimbabwe,ZWE,2018,4848158,10204026,15052184
Zimbabwe,ZWE,2019,4945719,10408889,15354608
Zimbabwe,ZWE,2020,5052214,10617452,15669666
Zimbabwe,ZWE,2021,5166388,10827136,15993524
